Gs^Fmf, Gg, Gs^Fp, Gs^Fp, Gs^Fp, Rd, Gg, Gg, Gg, Ww, Gg, Gg, Hh^Es, Hh, Hh, Hh^Fms, Hh, Hh^Fms, Hh^Fms, Hh^Fms, Gs, Gs^Fmf, Gg^Fp, Gs^Fds, Gll^Fp, Gll^Fp, Gll^Fp, Gll^Fp, Gll^Fp, Gll^Fp, Gs, Gs^Fds, Gg^Fp, Gs^Fp, Gs^Fp, Gg^Fp, Gs^Fms, Gg, Gs^Fp, Gg, Gll^Fp, Gg, Gs^Fp, Gs^Fms
Gs^Fds, Gs^Fmf, Gll^Fdw, Gll^Fdw, Gll, Gd, Gs, Gg, Gs, Gg, Gg, Gg, Hh, Hh^Fds, Hh^Fds, Hh, Hh, Hh^Fms, Gg, Gg, Gs^Es, Rd, Rd, Rb^Fdw, Re, Rb^Fdw, Rb^Fdw, Re^Fmw, Rd, Gll^Fmf, Gs, Gs, Gg, Gg^Es, Gs^Fp, Gs^Fms, Gll^Fmf, Gll^Fp, Gll^Fp, Gg^Fet, Gs^Fp, Gs^Fp, Gs^Fp, Gs^Fms
Gs^Fms, Gll, Gd^Fetd, Rd, Rd, Rd, Rd, Re, Re, Gg, Gg, Hh, Hh, Hh, Hh^Es, Hh, Hh^Fp, Gs, Gg, Gg, Gg, Gs, Gg, Rd, Re, Rb, Rb, Re, Rd, Rd, Gg^Efm, Gg, Gg, Gg, Gg, Gs^Fp, Gs^Fp, Gs^Fds, Gs^Fms, Gs^Fp, Gs, Gs^Fms, Gs^Fp, Gs^Fms
Gs^Fms, Gll, Re, Rd, Rd, Rd^Ecf, Rd, Re, Re, Gs, Gs, Hh, Gg, Hh, Hh^Fds, Hh, Gg, Gg, Gs, Gg, Gs, Gg, Gg, Gg, Rd, Rb^Vhr, Rb, Rb, Gs, Gg, Gg, Gg, Gg, Gg, Gg, Gg^Efm, Gs, Gs^Fp, Gs^Fp, Gs, Gs, Gs^Fms, Gg, Gg^Fms
Gll, Gll, Gs^Es, Re, Rd, Rd, Re, Rb, Rb, Rb, Re, Gs, Gg, Hh, Gs, Gg^Efm, Gg, Gg, Gs, Gs^Es, Gs, Gg, Gg, Gg, Rd, Rb, Rd, Re, Gg, Gg, Gg, Gg, Gg, Gg, Gg, Gg, Gs, Gs, Gs^Es, Gs, Gg, Gg, Gs, Gg^Fms
Gg, Gg, Gs, Re^Dr, Re, Re, Re, Re, Ket, Rd, Ce, Re, Re, Gs, Gg, Gg, Gg, Gs, Gg, Gs, Gs, Gs, Gg, Rd, Gs, Re, Gg, Rd, Gg, Gg, Gg, Gg, Gg^Em, Gg, Gg, Gg, Gg, Gg, Gg, Gs, Gg, Gg, Gs^Fms, Gg^Fms
Gg, Gg, Gs, Gs, Rd, Re, Rd^Dr, Rb, Rb^Fetd, Rb^Vct, Re, Ce, Rb, Ket, Ce, Gg, Ur^Dr, Gg, Gg, Gg, Gg, Gs, Rd, Gg, Gg, Gs, Gg, Gg^Efm, Gg, Gg, Gs, Gg, Gs, Gg, Gg, Gg, Gg, Gg, Gg^Em, Gg, Gs^Fp, Gg, Gs^Fp, Gg^Fms
Rb, Gs, Rd, Rd, Ce, Ce, Re, Re, Rb, Rb, Re, Re, Re, Re, Re, Rb, Rb, Ce, Ce, Ket, Ce, Gs, Rd, Gg, Gg, Gs, Gs, Gg, Gg, Gg, Gs, Gs, Gs, Gg, Gg, Gg, Gg, Gg, Gs^Fds, Gs^Fp, Gs^Fp, Gs^Fp, Gs^Fms, Gg^Fms
Gg, Rd, Re, Rd^Dr, Rb, Re, Re, Rb^Ecf, Re, Re, Ce, Ce^Vct, Ke, Ce, Re, Rb, Rb^Ecf, Rb, Re, Re, Re, Rd, Gg, Gg, Gg^Esd, Gs, Gs, Gg, Gg, Gg, Gll^Fp, Gs, Gs, Gs, Gg, Gg, Gg, Gs^Fms, Gs^Fp, Gs^Fp, Gs^Fms, Gll^Fdf, Gs^Fms, Gg^Fds
Rd, Re, Rb, Ket, Rb, Rb^Fetd, Rb, Rb, Rb, Ce^Vct, Rd, Ce, Re, Ce, Rb, Re, Rb, Rb, Rb, Re, Rd^Vct, Ket^Edt, Rb, Gg, Gg, Gg, Gs, Gs, Gs^Fmf, Gs^Fds, Gs^Fp, Gll^Fdf, Gg, Gg, Gg, Gg, Gg, Gs^Fms, Gll^Fdf, Gs^Fms, Gll^Fdf, Gs^Fms, Gs^Fms, Gg^Fds
Rb, Rd, Re, Ce, Re, Re, Rb^Vct, Re, Rb, Ket, Ce^Vct, Ce, Ce^Vct, Ket, Rb, Rb, Re, Rb^Fetd, Rd, Rd, Re, Ce^Dr, Rb, Gg, Gg, Gg, Gg, Gg, Gs^Fmf, Gs^Fds, Gg^Fet, Gs^Fp, Gg, Gg, Gg, Gg, Gg, Gg, Gs^Fms, Gs^Fms, Gs^Fms, Gs^Fms, Gs^Fms, Gg^Fds
Rb, Rd, Rd, Rb, Rd, Re, Re, Rb, Rb, Re, Rb, Ce, Re, Re, Rb, Re, Rb, Rb, Re, Rd, Ket, Ce, Gg, Gg, Gg, Gg^Efm, Gs^Fmf, Gs^Fds, Gs^Fds, Gs^Fds, Gs, Gg, Gs, Gg, Gg, Gg, Gg, Gg, Gll^Fmf, Gs^Fms, Gs^Fms, Gs^Fms, Gs^Fds, Gs^Fms
Ww, Rb, Ww, Ur^Dr, Ket, Rd, Ce, Re, Rb, Rb, Re, Rb, Rb, Rb^Ecf, Rb, Re, Rb, Re, Ket, Rd, Rb, Gg, Gg, Gg, Gg, Gg, Gs^Fds, Gs^Fds, Gs^Fms, Gs^Fms, Gll^Fmf, Gs, Gg, Gs, Gg, Gg, Gg, Gg, Gg, Gs^Fms, Gs^Fds, Gs^Fds, Gll^Fmf, Gs^Fds
Ww, Ww, Ww, Ww^Edt, Ww^Edt, Ce, Wwf^Es, Ur^Dr, Rb^Em, Ket, Ce, Re, Ce, Re, Re, Rb^Vct, Ce, Ce, Rb, Gs, Gs, Gg, Gg^Es, Gg, Gg, Gg, Gg, Gg, Gg, Gs^Fms, Gs, Gs, Gg, Gg, Gg, Gg, Gg^Em, Gg, Gs^Fms, Gs^Fds, Gs^Fds, Gll^Fmf, Gs^Fms, Gg^Fms
Gg, Wwf^Es, Rb, Ww, Rb, Ww^Edt, Ww, Ww^Edt, Ww, Ww^Edb, Ww, Rb^Dr, Ww, Ce, Re, Ket, Gs, Re, Gs, Gs, Gs, Re, Gg, Gg, Gg, Gg, Gg, Gg, Gs, Gs^Es, Gg, Gg, Gg, Gg, Gg, Gs^Fds, Gs^Fds, Gs^Fds, Gs^Fms, Gs^Fms, Gs^Fms, Gs^Fds, Gs^Fms, Gg^Fms
Gg, Gg, Gg, Gg, Gg, Gg, Gs, Re, Gg, Ww, Re, Ww^Edt, Rb, Ww, Ww, Gg, Gs, Gs, Gs, Gs, Gs, Gg, Gg, Gg, Gs, Gs, Gg, Gs, Gg, Gg, Gg, Gg, Gg, Gg, Gs^Fds, Gs^Fds, Gs^Fms, Gs^Fms, Gs^Fds, Gll^Fdf, Gll^Fdf, Gs^Fms, Gs^Fds, Gg^Fms
Gg, Gg, Gg, Gg, Gg, Gs, Gs^Es, Gg, Gg, Gg, Gg, Re, Gg, Re, Ww, Rb, Re, Gs, Gs, Gg, Gg, Gg, Re, Gs, Gs, Gs, Rd, Gg, Re, Gll^Fdf, Gg, Gg, Gg, Gs^Fms, Gs^Fms, Gll^Fmf, Gs^Fds, Gs^Fms, Gs^Fms, Gs^Fms, Gs^Fms, Gs^Fms, Gs^Fms, Gg^Fms
Gs^Fds, Gs^Fmf, Gs^Fmf, Gs^Fds, Gs^Fds, Gs^Fms, Gll^Fdf, Gs^Fds, Gll^Fdf, Gg, Gg, Gg, Gg, Gg, Rb, Ww, Gg, Gg, Gg, Gg, Gs, Gg, Gs, Re, Re, Gd, Re, Rd, Re, Gs^Fds, Gs^Fms, Gll^Fmf, Gll^Fp, Gs^Fds, Gs^Fms, Gs^Fms, Gs^Fms, Gll^Fdf, Gll^Fmf, Gs^Fms, Gs^Fds, Gll^Fdf, Gll^Fdf, Gg^Fms
Gg, Gs^Fms, Gs^Fms, Gg, Gs, Gg^Em, Gg, Gs^Fp, Gs^Fms, Gs^Fms, Gs^Fms, Gg, Gg, Gg, Re, Ww, Re, Gg, Gg, Gg^Vhr, Gs^Es, Gs, Gs, Gs, Gs, Re, Rb, Rb, Rb, Rb^Fmw, Gs^Fds, Gll^Fp, Gs^Fds, Gs^Fms, Gs^Fms, Gg, Gg, Gs^Fds, Gs^Fms, Gs^Fms, Gs^Fms, Gs^Fds, Gs^Fms, Gll^Fmf
Gs^Fms, Gs^Fmf, Gs^Fms, Gs^Fds, Gs^Fds, Gs, Gs^Fds, Gs^Fms, Gg, Gs^Fms, Gg, Gg, Gg, Gg, Ww, Wwr, Wwf, Gg, Gg, Gs, Gs, Gs, Gs, Gs, Gs, Gd, Re, Rb^Vhr, Rb, Rb^Fmw, Rb^Fp, Gs^Fms, Gs^Fds, Gll^Fmf, Gg, Gg, Gg^Fet, Gg, Gs^Fms, Gs^Fms, Gs^Fms, Gs^Fds, Gll^Fdf, Gll^Fmf
Gs^Fds, Gs^Fp, Gll^Fp, Gs^Fms, Gs^Fmf, Gs^Fms, Gs, Gs, Gg, Gg, Gs^Es, Gg, Gg, Gg, Gg, Rb, Gg, Wwf, Gg, Gs, Gs, Gs, Gg, Gg^Efm, Gg, Gs, Rd, Rb, Rb^Fmw, Rd, Gll^Fdf, Gg, Gs^Fds, Gg, Gg, Gg, Gg, Gg, Gg, Gll^Fdf, Gll^Fdf, Gs^Fms, Gs^Fds, Gll^Fdf
Gs^Fp, Gll^Fp, Gs^Fp, Gs^Em, Gs, Gg, Gg, Gs, Gg, Gg, Gg, Gs, Gg, Gs, Gs, Gs, Gs, Wwf^Es, Gs, Gs, Gs, Gg, Gg, Gg, Gg, Gg, Gg, Re, Gs^Fms, Gs^Fds, Gll^Fdf, Gs^Fds, Gs^Fms, Gg, Gg, Gg^Efm, Gg, Gg^Em, Gs^Fms, Gs^Fds, Gs^Fms, Gs^Fms, Gs^Fms, Gg^Fms
Gll^Fp, Gll^Fp, Gll^Fp, Gs, Gg, Gg, Gg, Gg, Gg, Gg, Gg, Gg, Gg, Gs, Gg, Gs, Gs, Gs, Gg, Gs, Gs, Gs, Gs, Gg, Gg, Gg, Gg, Gg, Gs^Fp, Gs^Fds, Gs^Fms, Gs^Fp, Gll^Fmf, Gs^Fms, Gg, Gg, Gll^Fdf, Gs^Fds, Gs^Fms, Gs^Fms, Gg, Gll^Fdf, Gll^Fdf, Gg^Fms
Gll^Fp, Gll^Fp, Gg^Efm, Gg, Gg, Gg, Gg, Gg, Gg, Gg^Efm, Hh, Hh^Fds, Gg^Efm, Gg, Gg, Gs, Gg, Gs, Gg, Gs, Gs, Gs^Vhr, Gs, Gg, Gg, Gg, Gg, Gg, Gg, Gs^Fp, Gs^Fms, Gs^Fds, Gg, Gll^Fmf, Gs^Fms, Gs^Fms, Gg, Gll^Fmf, Gs^Fds, Gs^Fms, Gg, Gs, Gs^Fms, Gg^Fp
Gs^Fms, Gs^Fp, Gs^Fms, Gg^Efm, Gg, Gg, Gg, Gg, Hh, Hh^Fmf, Hh, Hh^Fds, Hh^Fms, Hh^Fms, Gg^Efm, Gg, Gg, Gg, Gg, Gs, Gs, Gs, Gs, Gg, Gg, Gg, Gg, Gg, Gs, Gs^Fds, Gll^Fmf, Gg, Gg, Gg, Gg, Gg, Gg, Gs^Fds, Gs^Fds, Gs^Fms, Gs, Gs, Gs^Fms, Gg^Fp
Gs^Fms, Gs^Fp, Gs^Fms, Gs^Vc, Gg^Es, Gg, Hh^Fmf, Gg, Hh, Hh, Gg, Hh, Hh^Fmf, Hh^Fms, Gg^Efm, Gg^Efm, Gg, Gg, Gg, Gg, Gg, Gg, Gg, Gg, Gg, Gg, Gg, Gg, Gs, Gs, Gs, Gg, Gg^Efm, Ce, Re^Vct, Gg, Gs^Fds, Gs^Fms, Gs^Fds, Gs, Gs^Fms, Gs^Fms, Gs^Fms, Gll^Fdf
Gs^Fms, Gs^Fms, Gs^Fms, Gs^Fp, Gs^Fmf, Gs^Fdf, Hh^Fms, Hh^Fms, Hh^Fms, Hh, Gg, Gg, Gg, Gg^Efm, Gg, Gg, Gg, Gg, Gg, Gg^Efm, Gg, Gs^Fms, Gs^Fms, Gs^Fp, Gs^Fp, Gg, Gs, Gs, Gs, Gs, Gg, Gg, Gg, Ce, Gs, Gg, Gs^Fms, Gs^Fms, Gs^Fmf, Gs^Fms, Gs^Fmf, Gs^Fmf, Gs^Fmf, Gs^Fms
Gs^Fms, Gs^Fp, Gs, Gs^Fms, Gs^Fms, Gs^Fms, Gs^Fmf, Hh^Fms, Gs^Fds, Gg, Gg, Gg, Chr, Gg, Gd, Gs, Gd, Gg, Gll^Fmf, Gs^Fms, Gs^Fds, Gs^Fds, Gs^Fds, Gll^Fp, Gg, Gg, Gs, Gs, Gg, Gg, Gg, Gg, Ce, Ket, Gs, Gs, Gs^Es, Gs^Fmf, Gs^Fds, Gs^Fms, Gs^Fds, Gs^Fms, Gs^Fms, Gs^Fms
Gs^Fds, Gs^Fms, Gs^Fms, Gs, Gs^Fms, Gs^Fms, Gs^Fms, Gs^Fms, Gs^Fds, Gs^Fms, Gg, Gg, Chr, Khr, Re, Rd, Rd^Fds, Gs^Fds, Gs^Fds, Gg, Gg, Gll^Fdf, Gll^Fdf, Gs^Fds, Gg, Gg^Efm, Gs, Re^Vct, Ce, Gs, Gs, Gg, Gg, Gs, Gs, Gs, Gs, Gs, Gs, Rd^Fdf, Gs, Gs, Gs, Gg
Gs^Fms, Gs^Fmf, Gs^Fds, Gs^Fms, Gs^Fds, Gs^Fms, Gs^Fdf, Gg^Es, Gg, Gg^Fet, Gg, Chr, Gs, Gd, Rb, Rb, Gs^Fms, Gs^Fms, Gs^Fms, Gs^Fms, Gs^Fp, Gs^Fds, Gs^Fdf, Gg, Gs^Fds, Gg^Es, Gs^Fdf, Ce, Ke, Ce, Gs, Gg, Gg, Gg, Gs, Gs, Gg, Gs, Gg, Gs, Gg^Fet, Gs, Gg, Gg
Gg^Em, Gs^Fms, Gs^Vc, Gs^Fms, Gs^Fmf, Gs^Fds, Gg, Gg^Efm, Gg, Gg, Gg, Gg, Gd, Rb, Rb^Vhr, Rd^Fds, Gs^Fms, Gs^Fds, Gs^Fds, Gs^Fmf, Gs^Fds, Gs^Fp, Gs^Fp, Gs^Fms, Gs^Fms, Gs^Fms, Gs^Fms, Gs, Gs, Gs, Gs, Gg, Gg, Gs, Gg, Gg, Gg, Gg, Gg, Gs, Gs, Gg, Gg, Gg
Gg, Gg, Gg, Gg, Gg, Gg, Gg, Gg, Gg, Gg, Gs, Gs, Gd, Re, Rb^Fms, Rb^Fds, Gs^Fds, Gs^Fds, Gs^Fms, Gs^Fds, Gs^Fds, Gs^Fms, Gs^Fms, Gs^Fds, Gs^Fds, Gs^Fds, Gs^Fds, Gs, Gg, Gs, Gg, Gg, Gg, Gs, Rd, Gg, Gg, Gg, Rb, Gs, Gg, Gg, Gg, Gg
