Re, Re, Rp, Re, Rb, Rd, Rb, Rb, Rb, Ww, Ww, Ww, Ww, Ww, Ww, Gs^Fms, Ww, Gs^Fms, Gs, Gs^Fms, Gs, Gs^Fds, Gg^Fp, Gs^Fds, Gll^Fp, Gll^Fp, Gll^Fp, Gll^Fp, Gll^Fp, Gll^Fp, Gg, Gs^Fds, Gg^Fp, Gs^Fp, Gs^Fp, Gg^Fp, Gs^Fms, Gg, Gs^Fp, Gg, Gll^Fp, Gg, Gs^Fp, Gg, Gs^Fp, Gg
Re, Rb, Rp^Vhcr, Rp, Rb, Rb, Ce, Re, Re, Cud, Chr, Ww^Edt, Chw, Ww, Ww, Ww, Ww, Ww, Ww, Ww, Gs^Es, Gs, Gs, Gg, Gs, Gll^Fp, Gs^Fp, Gll^Fp, Gll^Fp, Gll^Fp, Gg, Gg, Gg, Gg^Es, Gs^Fp, Gs^Fms, Gll^Fmf, Gll^Fp, Gll^Fp, Gll^Fp, Gs^Fp, Gs^Fp, Gs^Fp, Gs^Fp, Gs^Fp, Gs^Fds
Rp, Re, Re, Re, Re, Ce, Rb, Rb, Rb, Re, Rb, Ce, Gd, Cud, Chw^Dr, Wwf, Cer, Ww, Ww, Ww, Wwf, Gs, Ww, Gs, Ww, Gs, Gs, Gs, Gs, Gg, Gg^Efm, Gg, Gg, Gg, Gg, Gs^Fp, Gs^Fp, Gs^Fds, Gs^Fms, Gs^Fp, Gs, Gs^Fms, Gs^Fp, Gs^Fp, Gll^Fmf, Gs^Fds
Rb, Rb, Rb, Rb, Re, Gd, Gd, Gd, Re, Re, Rb, Rb, Rb, Gd, Rp^Vhr, Ce, Ur^Dr, Wwf, Wwf^Edb, Ww, Chw, Ww, Wwf, Ww, Ww, Ww, Ww, Gs, Gs, Gg, Wwf, Gg, Gg, Gg, Gg, Gg^Efm, Gg, Gs^Fp, Gs^Fp, Gs, Gg, Gs^Fms, Gs, Gll^Fmf, Gs^Fms, Gs^Fds
Rp, Ce, Re, Gd, Gd, Gd, Gs^Es, Gs, Gs, Re^Vhcr, Wwf, Rb, Rb, Rp, Gd^Es, Rp, Wwf, Ww, Rb^Dr, Ce, Gs, Gs, Ur^Dr, Ww, Gs, Ww, Ww^Edt, Ww, Ww, Ww, Ww, Ww, Ww, Gg, Gg, Gg, Gg, Gg, Gg^Es, Gg, Gg, Gg, Gs, Gs^Fms, Gll^Fp, Gs^Fds
Rp, Rp^Es, Re, Gd^Vhr, Ww, Wwf, Wwf, Wwf, Cud, Rb, Ce, Wwf, Wwf, Wwf, Wwg^Edb, Gd, Wwf, Wwf, Rp^Es, Rp, Rp, Gs, Rp, Cer, Gs, Gs^Dr, Cud, Ww, Ww, Ww, Ww, Gg, Gg^Em, Gg, Gg, Gg, Gg, Gg, Gg, Gg, Gg, Gg, Gs^Fms, Gs^Fp, Gs^Fms, Gs^Fds
Rb, Rb, Wwf, Ww, Ww^Edt, Ww^Edt, Ur^Dr, Rb, Rb^Fetd, Rb^Vhcr, Rr, Chr, Xos, Chr, Cud, Wwg, Ur^Dr, Wwf, Wwf, Ww, Wwf, Gs, Gs, Rp, Gs, Gs, Gg^Dr, Cer, Ww^Edb, Wwf, Gs, Gg, Gs, Gg, Gg, Gg, Gg, Gg, Gg^Em, Gg, Gs^Fp, Gg, Gs^Fp, Gs^Fms, Gll^Fmf, Gs^Fms
Rb, Rb, Wwf, Wwf^Edt, Cud, Chw, Rp, Rp, Rb, Rb, Rr, Rr, Rr, Rr, Rp, Xos, Rb, Ce, Xos, Ce, Ce, Wwf, Ww, Rp, Rp, Gs, Gs, Gs^Edb, Ww^Edb, Ww, Gs, Gs, Gs, Gg, Gg, Gg, Gg, Gg, Gs^Fds, Gs^Fp, Gs^Fp, Gs^Fp, Gs^Fms, Gs^Fp, Gs^Fp, Gs^Fds
Rb, Rb, Wwf, Rb^Dr, Rb, Rr, Rp, Rb, Rp^Es, Rr, Khr, Co, Khr, Co, Rr, Rb, Rb, Rb, Rr, Rr, Rr, Xos, Ww^Edt, Gd, Wwf, Gs, Gs, Ur^Dr, Wwf, Wwf, Gs, Gs, Gs, Gs, Gg, Gg, Gg, Gs^Fms, Gs^Fp, Gs^Fp, Gs^Fms, Gll^Fdf, Gs^Fms, Gs^Fms, Gs^Fms, Gs^Fms
Rp, Ww, Ww, Ce, Rb, Rb^Fetd, Rb, Rb, Rb, Cud^Vct, Xoc, Cud^Vhcr, Xoc, Cud, Rb, Rp, Rb, Rb, Rb, Rr, Rp^Vhcr, Ce^Edt, Ww, Wwf, Gd^Es, Rp, Gs, Gs, Ww, Wwf, Wwf, Gs, Gg, Gg, Gg, Gg, Gg, Gs^Fms, Gll^Fdf, Gs^Fms, Gll^Fdf, Gs^Fms, Gs^Fms, Gs^Fms, Gs^Fms, Gs^Fds
Rp^Ecf, Ww, Ww^Edb, Cud, Rp, Rp, Rb^Vhcr, Rr, Rb, Cud, Chr^Vct, Cud, Chr, Cud, Rb, Rb, Rr, Rb^Fetd, Rr, Rp, Rp, Ce^Dr, Wwf, Wwf, Gd, Rp, Rp^Vhr, Cud, Ww, Ww, Ww, Ww, Gg, Gg, Gg, Gg, Gg, Gg, Gs^Fms, Gs^Fms, Gs^Fms, Gs^Fms, Gs^Fms, Gs^Fds, Gs^Fms, Gs^Fms
Rp, Rp, Ww^Edb, Xos, Rr, Rp, Rp, Rb, Rb, Rp, Rb, Co, Rp, Rp, Rb, Rp, Rb, Rb, Xos, Rr, Rr^Pr/o, Xos, Gd, Gd, Rp, Rp, Gs, Ce^Dr, Ww^Edt, Ww, Gs, Ww, Gs, Gg, Gg, Gg, Gg, Gg, Gll^Fmf, Gs^Fms, Gs^Fms, Gs^Fms, Gs^Fds, Gll^Fmf, Gs^Fds, Gs^Fds
Rb, Rb^Es, Ww, Ur^Dr, Cud, Rp, Chw, Rp, Rb, Rb, Rr, Rb, Rb, Rb, Rb, Rr, Rb, Rr, Rr^Pr/o, Xos, Rb, Rp, Rp, Gd, Rp, Gs, Gs, Chw, Ww^Edt, Ww, Gs, Gs, Gg, Gs, Gg, Gg, Gg, Gg, Gg, Gs^Fms, Gs^Fds, Gs^Fds, Gll^Fmf, Gs^Fms, Gs^Fms, Gs^Fds
Rp, Rb, Re, Wwf, Wwf, Xos, Wwf, Ur^Dr, Xos, Ce, Ce, Rp, Chw, Rp, Rp, Rb^Vhr, Cud, Xos, Gd^Es, Rp, Rp, Gs, Gs, Rp, Gs, Gs, Gs^Es, Gs^Dr, Ww, Ww, Gs, Gs, Gg, Gg, Gg, Gg, Gg^Em, Gg, Gs^Fms, Gs^Fds, Gs^Fds, Gll^Fmf, Gs^Fms, Gs^Fms, Gs^Fms, Gs^Fms
Rp, Rp, Rp, Gs, Gs, Ww, Gs, Wwf, Ww^Edb, Ww^Edb, Wwg, Rb^Dr, Ww, Cud, Xos, Ce, Ww^Edb, Ww, Gd^Vo, Gd, Gs, Rp, Rp, Rp, Gs^Vo, Gs, Ce^Eb, Ce, Gs, Gs^Es, Gg, Gg, Gg, Gg, Gg, Gs^Fds, Gs^Fds, Gs^Fds, Gs^Fms, Gs^Fms, Gs^Fms, Gs^Fds, Gs^Fms, Gs^Fms, Gs^Fms, Gs^Fds
Rb^Es, Re, Rp, Rp^Vhr, Gs, Gs^Vo, Gs, Gs, Wwf, Ww, Ww, Ww, Gs, Ww, Ww, Ww, Gs, Gs, Gd, Gd, Gd, Gs, Rp, Gs, Gs, Gs, Gg, Gs, Gg, Gg, Gg, Gg, Gg, Gg, Gs^Fds, Gs^Fds, Gs^Fms, Gs^Fms, Gs^Fds, Gll^Fdf, Gll^Fdf, Gs^Fms, Gs^Fds, Gs^Fds, Gs^Fms, Gs^Fds
Ce, Rb, Rb, Rb^Dr, Rb^Dr, Gs, Gs^Es, Ww, Gd, Gd, Rp, Gs, Rp, Wwf, Rp, Gs, Rp, Rp, Rp, Rp, Rp, Gd, Rp, Gs, Gs, Gs, Gg, Gg, Gg, Gg, Gg, Gg, Gg, Gg, Gs^Fds, Gll^Fmf, Gs^Fds, Gs^Fms, Gs^Fms, Gs^Fms, Gs^Fms, Gs^Fms, Gs^Fms, Gll^Fmf, Gs^Fms, Gs^Fds
Ww, Cud, Ww, Wwf, Ww, Chw, Cud, Ce, Chr^Vhr, Rp, Rb, Rp, Gd, Wwf, Rp^Vhr, Rp, Gs, Gd, Gd, Gd, Gs, Rp, Gs, Gs, Gs, Gg, Gg, Gg, Gg, Gg, Gg, Gg, Gg, Gg, Gs^Fms, Gs^Fms, Gs^Fms, Gll^Fdf, Gll^Fmf, Gs^Fms, Gs^Fds, Gs, Gs, Gs^Fms, Gs^Fms, Gs^Fds
Ww, Ww, Gg, Ww, Gs, Ww, Ww, Rb, Ww^Edt, Ur^Dr, Chw, Ce, Cud, Gd, Gd^Dr, Gs, Chw, Chr, Ce, Ce^Eb, Gs^Es, Gs, Gs, Gs, Gs, Gs, Gg, Gg, Gg, Gg, Gg, Gg, Gg, Gg, Gs^Fds, Gg, Gg, Gs^Fds, Gs^Fms, Gs^Fms, Gs^Fms, Gs, Gs^Fms, Gs^Fds, Gs^Fms, Gs^Fds
Gg, Ww, Gg, Gg, Gs, Gs, Gs, Ww, Ww, Xos, Wwg, Wwg^Edt, Wwf, Chr, Wwg, Rb^Dr, Wwg, Wwf, Wwg, Gs, Gs, Gs, Gs, Gs, Gs, Gs, Gg, Gg^Vo, Gg, Gg, Gg, Gg, Gg, Gg, Gg, Gg, Gg^Fet, Gg, Gs^Fms, Gs^Fms, Gs^Fms, Gs^Fds, Gs^Fms, Gs^Fds, Gll^Fmf, Gs^Fds
Gg, Gg, Gg, Gg, Gg, Gg, Gs, Gs, Gg, Wwg, Gs^Es, Wwf, Wwg, Wwf, Wwg, Wwf, Gs, Wwg, Wwf, Gs, Gs, Gs, Gg, Gg^Efm, Gg, Gs, Gg, Gg, Gg, Gg, Gg, Gg, Gg, Gg, Gg, Gg, Gg, Gg, Gg, Gll^Fdf, Gll^Fdf, Gs^Fms, Gs^Fds, Gll^Fmf, Gs^Fds, Gs^Fds
Gs^Fp, Gg^Efm, Gg^Efm, Gg, Gg, Gg, Gg, Gs, Gg, Gg, Gg, Gs, Gg, Gs, Gs, Gs, Gs, Gg, Gs, Gs, Gs, Gg, Gg, Gg, Gg, Gg, Gg, Gg, Gg, Gg, Gs, Gg, Gg, Gg, Gg, Gg^Efm, Gg, Gg^Em, Gs^Fms, Gs^Fds, Gs^Fms, Gs^Fms, Gs^Fms, Gs^Fms, Gs^Fms, Gs^Fms
Gll^Fp, Gll^Fp, Gll^Fp, Gg, Gg, Gg, Gg, Gg, Gg, Gg, Gg, Gg, Gg, Gs, Gg, Gs, Gs, Gs, Gg, Gs, Gs, Gs, Gs, Gg, Gg, Gg, Gg, Gg, Gs, Gs, Gs, Gs, Gg, Gg, Gg, Gg, Gs^Fds, Gs^Fds, Gs^Fms, Gs^Fms, Gg, Gll^Fdf, Gll^Fdf, Gs^Fms, Gs^Fds, Gs^Fds
Gll^Fp, Gll^Fp, Gg^Efm, Gg, Gg, Gg, Gg, Gg, Gg, Gg^Efm, Hh, Hh, Gg^Efm, Gg, Gg, Gs, Gg, Gs, Gg, Gs, Gs, Gs^Vo, Gs, Gg, Gg, Gg, Gg, Gg, Gg, Gs, Gs, Gs, Gg, Gg, Gg, Gg, Gg, Gll^Fmf, Gs^Fds, Gs^Fms, Gg, Gs, Gs^Fms, Gs^Fms, Gs^Fms, Gs^Fms
Gs^Fms, Gs^Fp, Gs^Fms, Gg^Efm, Gg, Gg, Gg, Gg, Hh, Hh, Hh, Hh, Hh, Hh, Gg^Efm, Gg, Gg, Gg, Gg, Gs, Gs, Gs, Gs, Gg, Gg, Gg, Gg, Gg, Gs, Gs, Gs, Gg, Gg, Gg, Gg, Gg, Gg, Gs^Fds, Gs^Fds, Gs^Fms, Gs, Gs, Gs^Fms, Gll^Fdf, Gs^Fms, Gs^Fds
Gs^Fms, Gs^Fp, Gs^Fms, Gs^Vc, Gg^Es, Gg, Hh^Fmf, Gg, Hh, Hh, Gg, Hh, Hh, Hh, Gg^Efm, Gg^Efm, Gg, Gg, Gg, Gg, Gg, Gg, Gg, Gg, Gg, Gg, Gg, Gg, Gs, Gs, Gs, Gg, Gg^Efm, Gg, Gg, Gg, Gs^Fds, Gs^Fms, Gs^Fds, Gs, Gs^Fms, Gs^Fms, Gs^Fms, Gs^Fms, Gs^Fms, Gs^Fds
Gs^Fms, Gs^Fms, Gs^Fms, Gs^Fp, Gs^Fmf, Gs^Fdf, Hh^Fms, Hh^Fms, Hh^Fms, Hh, Gg, Gg, Gg, Gg^Efm, Gg, Gg, Gg, Gg, Gg, Gg^Efm, Gg, Gg, Gg, Gg, Gg, Gg, Gs, Gs, Gs, Gs, Gg, Gg, Gg, Gg, Gg, Gg, Gs^Fms, Gs^Fms, Gs^Fmf, Gs^Fms, Gs^Fmf, Gs^Fmf, Gs^Fmf, Gs^Fds, Gs^Fms, Gs^Fms
Gs^Fms, Gs^Fp, Gs, Gs^Fms, Gs^Fms, Gs^Fms, Gs^Fmf, Hh^Fms, Gs^Fds, Gg, Gg, Gg, Chr, Gg, Gg, Gg, Gg, Gg, Gg, Gg, Gg, Gg, Gg, Gg, Gg, Gg, Gs, Gs, Gg, Gg, Gg, Gg, Gg, Gg, Gg, Gs, Gs^Es, Gs^Fmf, Gs^Fds, Gs^Fms, Gs^Fds, Gs^Fms, Gs^Fms, Gs^Fms, Gs^Fms, Gs^Fds
Gs^Fds, Gs^Fms, Gs^Fms, Gs, Gs^Fms, Gs^Fms, Gs^Fms, Gs^Fms, Gs^Fds, Gs^Fms, Gg, Gg, Chr, Khr, Gs, Gs, Gs, Gg, Gg^Es, Gg, Gg, Gg, Gg, Gg^Fet, Gg, Gg^Efm, Gs, Gs, Gg, Gg, Gg, Gg, Gg, Gg, Gs, Gs, Re, Re, Rb, Gll^Fdf, Re, Re, Re, Gll^Fdf, Re, Gs^Fms
Gs^Fms, Gs^Fmf, Gs^Fds, Gs^Fms, Gs^Fds, Gs^Fms, Gs^Fdf, Gg^Es, Gg, Gg^Fet, Gg, Chr, Gs, Gd, Rb, Rb, Gs^Fms, Gs^Fms, Gs^Fms, Gs^Fms, Gs^Fp, Gg, Gs^Fdf, Gg, Gs^Fds, Gg^Es, Gs^Fdf, Gg, Gg, Gg, Gg, Gg, Gg, Gg, Gs, Gs, Re, Re, Rb^Fdw, Rb, Rb, Rb^Vhr, Re, Re, Re, Re
Gg^Em, Gs^Fms, Gs^Vc, Gs^Fms, Gs^Fmf, Gs^Fds, Gg, Gg^Efm, Gg, Gg, Gg, Gg, Gd, Rb, Rb^Vhr, Rb^Fds, Gs^Fms, Gs^Fds, Gs^Fds, Gs^Fmf, Gs^Fds, Gs^Fp, Gs^Fp, Gs^Fms, Gs^Fms, Gs^Fms, Gs^Fms, Gg, Gg, Gg, Gg, Gg, Gg, Gs, Gs, Re, Re, Re, Rb, Rb, Rb, Rb, Rb^Fdw, Re, Gs, Gs
Gg, Gg, Gg, Gg, Gg, Gg, Gg, Gg, Gg, Gg, Gs, Gs, Gd, Rb, Rb^Fms, Rb^Fds, Gs^Fds, Gs^Fds, Gs^Fms, Gs^Fds, Gs^Fds, Gs^Fms, Gs^Fms, Gs^Fds, Gs^Fds, Gs^Fds, Gs^Fds, Gs^Vc, Gg, Gg, Gg, Gg, Gg, Gs, Gs, Re, Re, Rb^Fdw, Rb, Rb^Vhr, Rb, Rb^Fdw, Rb^Fdw, Re, Gs, Gs
Gg, Gg, Gg, Gg, Gg, Gg, Gg^Es, Gg, Gs^Fds, Gs^Em, Gs^Fms, Gd, Gs^Fms, Gs^Fds, Gs^Fms, Gs^Fms, Gs^Fms, Gs^Fms, Gs^Fms, Gs^Fms, Gs^Fds, Gs^Fdf, Gs^Fds, Gs^Fms, Gll^Fmf, Gs^Fms, Gs^Fds, Gs^Fds, Gg, Gg, Gg, Gg, Gg, Gg, Gs, Gs, Re, Re, Re, Rb, Re, Rb^Fdw, Rb, Re, Gs, Gs
Gs^Fms, Gg^Es, Gs^Fms, Gs^Fp, Gs^Fp, Gs^Fp, Gs^Fmf, Gs^Fdf, Gs^Fds, Gs^Fms, Gs^Fds, Gs^Fdf, Gs^Fds, Gll^Fmf, Gll^Fmf, Gs^Fms, Gs^Fds, Gs^Fms, Gg, Gs^Fms, Gs^Fms, Gs^Fds, Gs^Fds, Gs^Fms, Gs^Fms, Gll^Fmf, Gs^Fds, Gs^Fms, Gs^Fds, Gg, Gg, Gg, Gg, Gg, Gs, Gs, Gs, Re, Gs, Re, Gs, Re, Gs, Re, Gs, Gs
Gs^Fms, Gs^Fms, Gs^Fds, Gs^Fds, Gs^Fms, Gs^Fms, Gs^Fms, Gs^Fms, Gs^Fms, Gs^Fms, Gll^Fmf, Gs^Fms, Gs^Fms, Gll^Fmf, Gs^Fms, Gs^Fms, Gg, Gg, Gg, Gg, Gg, Gs^Fds, Gs^Fdf, Gs^Fds, Gs^Fms, Gs^Fp, Gs^Fp, Gs^Fms, Gs^Fdf, Gg^Efm, Gg, Gg, Gg, Gg, Gg, Gs, Gg, Gs, Gs, Gs, Gs, Gs, Gs, Gs, Gs, Gs
Gs^Fms, Gs^Fms, Gs^Fds, Gs^Fdf, Gs, Gs, Gs^Fds, Gs^Fms, Gs^Fms, Gs^Fds, Gs^Fms, Gs^Fms, Gs^Fms, Gs^Fds, Gg, Gg, Gll^Fmf, Gs, Gs, Gg, Gs^Fms, Gg, Gs^Fms, Gs^Fds, Gs^Fms, Gs^Fms, Gs^Fp, Gs^Fms, Gs^Fdf, Gg, Gg, Gg, Gg, Gg, Gg, Gg, Gg, Gg, Gg, Gs, Ce, Ke, Ce, Gg, Gg^Es, Gs
Gs^Fms, Gs^Fms, Gg, Gs, Gs^Fms, Gs, Gs^Fds, Gs^Fms, Gs^Fms, Gs^Fms, Gs^Fmf, Gs^Fms, Gs, Gg, Gg, Gll^Fmf, Gs, Gs, Gg, Gg, Gg, Gs, Gll^Fmf, Gs^Fds, Gs^Fms, Gs^Fms, Gs^Fds, Gs^Fds, Gs^Fds, Gs^Fds, Gg, Gg, Gs, Gg, Ce, Gg, Gg, Gg^Fet, Gg, Gg, Gg, Ce, Gg, Gg, Gg, Gg
Gs^Fds, Gs^Fds, Gg, Gg, Gs^Fds, Gs^Fms, Gs^Fms, Gs^Fms, Gll^Fmf, Gs^Fds, Gs^Fmf, Gs^Fms, Gs^Fms, Gg, Gg, Gs, Gg, Gg, Gg, Gg, Gg, Gs, Gs^Fms, Gll^Fmf, Gs^Fms, Gs^Fms, Gll^Fmf, Gs^Fms, Gs^Fds, Gs^Fds, Gs^Fms, Gs, Ce, Gs, Ce, Gg, Gg, Gg, Gg, Gg, Gg, Gg, Gg, Gg, Gg, Gg
Gs^Fms, Gs^Fds, Gs^Fds, Gs^Fms, Gs^Fms, Gs^Fmf, Gs^Fms, Gs^Fms, Gs^Fms, Gs^Fds, Gs^Fms, Gs^Fds, Gs^Fds, Gs^Fds, Gs^Fdf, Gg, Gs, Gs, Gs, Gs^Fms, Gg, Gs^Fms, Gs^Fms, Gs^Fds, Gs^Fms, Gs^Fds, Gs^Fms, Gs^Fms, Gs^Fms, Gs^Fms, Gll^Fmf, Gs^Fds, Gs^Fds, Ket, Gg, Gg, Gg, Gg, Gg, Gs, Gs, Gg, Gg, Gg, Gg, Gg
Gs^Fms, Gs^Fms, Gs^Fmf, Gs^Fds, Gs^Fmf, Gs^Fms, Gs^Fds, Gs^Fds, Hh^Fds, Gs^Fms, Hh^Fms, Hh^Fms, Hh^Fp, Gll^Fmf, Hh^Fds, Hh^Fds, Hh^Fms, Gs^Fms, Gs^Fms, Gs, Gs^Fms, Gs^Fms, Gs^Fms, Gs^Fdf, Gs^Fms, Gs^Fms, Gll^Fmf, Gs^Fms, Gs^Fms, Gs^Fms, Gs^Fds, Gs^Fms, Gs^Fms, Gs^Fds, Gs^Fds, Gg, Gg, Gg, Gg, Gs, Gs, Gs, Gs, Gg, Gg, Gg
Gs^Fms, Gs^Fms, Gs^Fms, Gs^Fms, Gs^Fms, Gs^Fms, Hh^Fds, Hh^Fdf, Hh^Fms, Hh^Fms, Hh^Fms, Hh^Fms, Hh^Fp, Hh^Fmf, Hh^Fds, Hh^Fms, Gs^Fms, Hh^Fms, Hh^Fdf, Gs^Fds, Gs^Fms, Gll^Fmf, Gs^Fms, Gs^Fms, Gs^Fms, Gs^Fms, Gs^Fds, Gs^Fds, Gs^Fds, Gs^Fms, Gs^Fms, Gs^Fds, Gs^Fdf, Gs^Fds, Gs^Fdf, Gs^Fds, Gg^Efm, Gg, Gg, Gg, Gg, Gg, Gg, Gg, Gg, Gg
Gs^Fds, Gs^Fds, Gs^Fms, Gs^Fds, Gs^Fms, Hh^Fms, Hh^Fms, Hh^Fms, Hh^Fms, Hh^Fms, Hh^Fms, Hh^Fds, Hh^Fms, Hh^Fds, Hh^Fds, Hh^Fds, Hh^Fds, Hh^Fds, Hh^Fms, Hh^Fds, Hh^Fds, Gs^Fms, Gs^Fms, Gs^Fms, Gs^Fds, Gs^Fds, Gs^Fms, Gs^Fms, Gs^Fds, Gs^Fds, Gs^Fds, Gs^Fds, Gs^Fds, Gs^Fdf, Gs^Fms, Gs^Fds, Gg^Es, Gg, Gg, Gg, Gg, Gg, Gg, Gg, Gg, Gg^Es
