Rrc, Mm, Rrc, Mm, Rrc, Co, Co, Wwg, Mm, Wwg, Wwg, Wwg, Co, Wwg, Hh^Fp, Ha^Fp, Mm, Mm, Mm, Ha, Hh, Hh, Hh, Hh, Hh, Gg, Gg, Gg, Gg, Gg, Gg, Gg, Gg, Rrc, Gg, Aa, Aa, Aa^Fp, Hh, Ha, Chr, Mm, Mm^Xm, Mm, Ms^Xm, Ms^Xm, Ms^Xm, Ms^Xm, Ms^Xm, Ms^Xm, Ms, Ms, Ms, Mm, Ms^Xm, Mm^Xm, Ms^Xm, Mm
Rrc, Rrc, Rp^Em, Aa, Aa^Esa, Rrc^Vo, Rrc, Gg^Es, Rp, Coa, Co, Gg, Gg, Wwg, Wwg, Hh^Fp, Hh, Coa, Mm, Ha^Voa, Ha^Esa, Hh, Hh, Hh, Gg, Gg, Gg, Aa^Fp, Aa^Fp, Gg, Aa^Esa, Gg, Gg, Rrc, Rrc, Gg, Gg, Aa^Fp, Gg, Hh, Hh, Hh^Fp, Hh, Ha^Vu, Mm, Ms, Ms, Ms^Xm, Ms^Xm, Ms^Xm, Ha^Fp, Ms, Ms^Xm, Ms^Xm, Ms^Xm, Ms^Xm, Ms, Ms
Ss, Gg, Gg, Rb, Rb, Rrc, Rp^Ecf, Rrc, Rrc, Rrc, Rrc, Rb, Gg, Co, Coa, Wwg, Hh, Hh, Ms, Ms, Ms, Hh, Hh, Gg, Gg, Gg, Gg, Aa, Aa, Aa, Aa^Fms, Aa^Fp, Gg, Gg, Rp, Gg, Gg, Gg, Gg, Gg, Gg, Gg, Gg, Hh, Hh, Mm, Ha, Ms^Xm, Ms, Hh^Fp, Ms, Hh, Ms, Ms, Ms, Ms, Ms, Ms
Sm, Sm, Ss, Gg, Coa, Co, Rp, Rd, Rrc, Rrc, Rrc, Rb, Rb, Co^Vo, Re, Wwg, Wwg, Hh, Hh^Fp, Ms, Mm, Hh, Hh, Hh, Gg, Aa, Aa, Aa, Gg, Gg, Aa, Aa^Fp, Cer, Gg, Rp, Gg, Aa, Gg, Aa^Esa, Gg, Gg, Gg, Gg, Gg, Gg, Hh, Hh, Hh^Fp, Mm, Ha^Esa, Hh, Ms^Xm, Ha^Fp, Ms, Ms, Ha^Esa, Ms^Xm, Ms^Xm
Ss, Ss, Sm, Sm, Sm, Co, Co, Ko, Rp, Rp, Aa^Esa, Rrc, Rrc, Gs, Aa, Co, Wwg, Wwg, Hh, Mm, Ms, Hh^Vo, Hh, Hh, Hh, Aa^Fp, Aa, Aa^Esa, Gg, Gg, Gg, Gg, Rrc, Rrc, Ker, Gg, Gg, Aa, Aa, Aa, Gg, Gg, Gg, Gg, Gg, Rb, Hh, Ms^Xm, Mm, Hh, Hh, Ms^Xm, Ha, Ms, Hh^Vud, Ms, Ms^Xm, Ms^Xm
Ss^Vo, Ss, Gs, Co^Vo, Co, Co, Ko, Coa, Co, Co^Vo, Aa, Gd, Rrc^Ecf, Rrc, Gs, Wwg, Coa, Wwf, Sm, Hh, Ms, Ms, Ms, Hh^Voa, Hh, Aa, Aa^Fms, Aa^Fp, Gg, Gg, Rb^Vo, Rb^Es, Rrc, Cer, Cer, Gg, Aa, Gg, Aa, Aa^Fp, Gg, Gg, Gg, Gg, Gg, Rb, Hh, Hh, Hh, Hh, Chr, Mm, Ms, Hh, Ms, Ha, Ms, Ms
Sm, Sm, Rp^Em, Co, Rp, Co, Co^Vo, Co, Rp, Co, Rp^Es, Gd, Gll^Fdw, Rrc, Gs^Es, Re, Gg, Co, Sm, Hh, Coa, Mm, Ms, Ms, Hh, Ha, Ha^Fp, Aa^Fms, Gg, Gg, Gg, Gg, Rrc, Gg, Gg, Gg, Aa^Es, Aa, Gg, Gg, Gg, Gg, Gg, Gg, Gg, Hh, Mm, Hh, Hh, Hh^Fp, Mm^Xm, Mm, Ms, Ms, Ms, Ms, Ms^Xm, Ms
Rrc, Rp, Rd, Rrc^Ecf, Rrc, Ko, Gs^Es, Co, Coa, Rp, Rrc, Gs, Rrc, Rrc, Rrc, Gs, Gg, Co, Wwg, Hh, Hh, Mm, Hh, Hh, Co, Hh, Gg, Gg, Gg, Gg, Gg, Gg, Rrc, Gg, Gg, Gg, Gg, Aa, Gg, Gg, Gg, Gg, Gg, Gg, Hh, Hh^Fp, Ms^Xm, Ms, Ha, Ms, Ms, Ms, Mm^Xm, Ms, Ms, Ms^Xm, Ms, Ms
Gs, Rb, Aa, Rd, Rrc, Rp, Gs, Co, Gs, Gs, Gs^Vo, Rrc, Rrc, Rb, Rb, Rrc, Rrc^Vo, Rrc, Rrc, Sm, Rb^Em, Hh, Rrc, Hh, Rp, Gg^Es, Rrc, Gg, Gg, Gg, Gg, Rrc, Gg, Gg, Gg, Rb, Rb, Gg, Gg, Gg, Gg, Gg, Aa^Esa, Hh, Ha, Ms, Ms^Xm, Ms, Ha, Ms, Ha, Hh^Fp, Ms^Xm, Ms, Ms, Ms, Ms, Ms
Gs, Gs^Es, Gll^Fdw, Aa^Esa, Rrc, Rrc, Rrc, Rp, Rrc, Rrc, Rrc, Rrc, Aa, Aa, Rb, Rrc, Rp, Rp, Rp, Rrc, Rp, Rrc, Hh, Rp, Co, Rrc, Gg, Rrc, Rp, Gg, Rp, Aa, Aa, Gg, Gg, Rb, Rb, Gg, Gg, Gg, Gg^Esa, Aa, Ha, Ha, Ms, Mm, Mm, Mm, Hh, Mm, Ha, Ms, Ms, Ms, Ms^Xm, Ms, Ms, Ms^Xm
Wwf, Wwg, Gg^Vo, Rrc, Aa, Rb, Rrc, Rrc, Rp^Ecf, Rd, Rrc, Rb, Aa, Aa, Aa, Rb, Ss, Wwg, Ss, Sm, Co, Hh, Ms, Hh, Hh, Hh, Gg, Gg, Gg, Rp, Gg, Gg, Aa, Aa^Esa, Aa, Gg, Gg, Gg, Aa, Aa, Aa, Aa, Ha, Ha^Fp, Mm^Xm, Ms^Xm, Hh, Mm, Hh, Ha, Ha^Esa, Ms, Ms, Ms, Ms, Ms, Ms, Ms
Ss, Sm, Gg, Gg^Es, Gs, Rb, Rrc, Rd, Gs, Rd, Gs, Rrc, Gg^Vo, Aa^Esa, Rd, Gs, Coa, Ss, Hh, Hh, Mm, Mm, Hh, Hh^Voa, Hh, Hh^Es, Gg, Gg, Aa, Gg, Aa^Fp, Gg, Gg^Es, Rb, Gg, Gg, Gg, Gg, Gg, Aa^Esa, Aa, Hh, Ha, Mm, Mm, Chr, Hh, Hh, Mm, Ha^Fp, Mm, Ms, Mm^Xm, Ms, Mm^Xm, Ms, Mm^Xm, Ms
Ss, Co, Wwg, Gg, Wwf, Gs, Rp, Rp, Re, Gs, Gg, Rrc, Rd, Re, Wwg, Co, Wwg, Hh, Hh, Hh^Fp, Ms, Mm, Hh, Hh, Hh, Gg, Gg, Gg, Aa^Efm, Aa, Aa, Gg, Gg, Rb, Gg, Gg, Gg, Gg, Aa, Aa, Hh, Hh, Hh, Hh, Hh, Hh, Hh, Mm, Mm, Mm, Mm^Xm, Mm^Xm, Xu, Ms^Xm, Xu, Ms^Xm, Ms^Xm, Ms^Xm
Ss, Sm, Sm, Wwg, Co, Co, Coa, Re, Wwg, Re, Co, Rp, Co, Wwg, Ss, Ss, Hh, Hh, Ms, Ms, Hh, Hh, Hh, Hh, Gg, Gg, Aa^Voa, Aa^Esa, Aa, Gg, Gg, Gg, Gg, Rb, Gg, Gg, Gg, Aa, Aa^Fp, Aa, Hh, Hh, Hh, Hh, Hh, Hh, Mm, Mm, Mm, Mm, Mm, Xu, Uh, Xu, Uh, Mm^Xm, Xu, Ms^Xm
Ss, Sm, Sm, Ss, Sm, Sm, Ss, Ss, Sm, Co, Ss, Rb, Sm, Sm, Ss, Hh, Hh^Fp, Ms, Ms, Ms, Hh, Hh, Gg, Gg, Gg, Aa, Aa^Fp, Aa, Gg, Gg, Gg, Gg, Gg, Rb, Rb, Gg, Gg, Gg, Aa^Fp, Ha, Ha^Fp, Ha^Vhha, Ms^Xm, Hh, Hh, Ha, Mm, Mm, Ms^Xm, Ms^Xm, Xu, Uh^Vu, Cte, Cte, Cte, Uh, Xu, Xu
Ha, Ss, Hh, Ss, Hh, Hh, Hh, Hh, Hh, Ss, Hh, Ss, Ha, Ha, Coa^Vo, Mm, Mm, Mm, Hh, Hh, Hh, Hh, Gg, Gg, Gg, Gg^Fp, Gg^Fp, Gg, Gg, Gg, Gg, Gg, Gg, Gg, Gg, Gs, Gg, Gg^Fms, Gg^Fp, Ha, Ha, Mm, Mm, Mm, Ha^Fp, Ha, Mm, Mm, Ms^Xm, Xu, Xu, Uh, Uh, Kte, Uu, Uu^Vu, Xu, Xu
Hh, Aa^Fms, Hh^Voa, Hh^Fp, Ms, Ms, Ms, Hh, Ha, Hh, Co, Hh, Aa^Fms, Ms, Ha, Mm, Hh, Hh, Hh, Hh, Gg, Gg, Gg, Gg, Gg, Gg, Gg, Gg, Gg, Gg, Gg, Gg, Gg, Gg, Gg, Gs, Gg, Gg, Gg^Fms, Hh, Ha, Mm, Ms, Ms, Mm, Ha, Chr, Mm, Hh, Ha, Uh, Uh, Uh, Cte, Uu, Uu, Uh, Xu
Ms, Ms, Ms, Ha^Fp, Ms, Ms, Hh, Mm, Mm, Mm, Ha, Mm, Ms, Ms, Ha^Esa, Hh, Gg, Hh, Gg, Gg, Gg, Gg, Gg, Gg, Gg, Gg, Gg, Gg, Gg, Gg, Gg, Aa^Vhr, Gg, Gg, Gg, Gs, Gg, Gg, Gg, Gg, Hh, Hh, Ms, Ms, Mm^Xm, Ha, Hh, Hh, Hh, Hh, Ms, Hh, Hh, Hh, Hh, Uu, Uh, Xu
Hh, Ms, Ha, Mm, Hh, Hh, Hh, Hh^Vo, Hh, Mm, Hh, Hh, Hh, Ha, Hh, Hh, Gg, Gg, Gg, Gg, Gg, Ha^Fp, Hh, Hh, Gg, Gg, Gg, Gg, Gg, Gg, Gg, Gg, Rb, Gg^Es, Gg, Gg, Gg, Gg, Gg, Gg, Hh, Hh, Hh, Mm, Ms, Hh, Hh, Hh, Mm, Ms, Xu, Hh^Vu, Hh, Uh, Uh, Uh, Xu, Xu
Hh, Hh, Hh, Ha^Esa, Gg, Hh, Hh, Hh, Hh, Hh, Gg, Hh, Hh, Hh, Aa, Gg, Gg, Gg, Gg, Gg, Gg, Ha^Esa, Ha, Hh, Gg, Gg, Gg, Gg, Gg, Gg, Rb, Rb, Gg^Es, Gg, Gg, Gg, Gg, Gg, Aa^Fp, Gg, Hh, Hh, Ha, Chr, Ms, Hh, Hh, Hh^Fp, Mm, Ms^Xm, Ms^Xm, Xu, Ms, Xu, Xu, Xu, Xu, Xu
Hh, Hh, Gg, Gg, Gg, Gg, Gg, Gg, Gg, Gg, Gg, Gg, Gg, Aa, Cer, Gg, Gg, Gg, Hh, Gg, Gg, Hh, Hh, Hh, Gg, Gg, Aa, Aa^Esa, Rb, Rb, Gg, Gg, Gg, Gg, Gg, Gg, Re, Rb, Aa, Aa, Gg, Hh, Ha^Fp, Ha, Hh, Hh, Ha, Ha^Vu, Ms, Ms, Ms^Xm, Ms, Ms^Xm, Ms^Xm, Ms^Xm, Xu, Ms^Xm, Ms^Xm
Ha, Hh, Gg, Gg, Hh, Gg, Hh, Gg, Cer, Gg, Gg, Gg, Gg, Aa, Gg, Gg, Ha, Hh, Ha^Fp, Ha, Gg, Gg, Gg, Gg, Gg, Aa^Es, Aa, Aa, Rb, Gg, Gg, Gg, Gg, Gg, Gg, Aa, Aa^Fp, Rb, Aa, Aa^Esa, Aa, Gg, Ha, Hh, Hh, Hh, Ha, Ms^Xm, Ms, Ms, Mm, Mm, Mm, Ms^Xm, Ms^Xm, Ms^Xm, Ms^Xm, Ms^Xm
Ha, Gg, Gg, Gg, Mm, Gg, Hh, Hh, Gg, Ker, Gg, Gg, Gg, Gg, Gg, Gg, Ha^Esa, Hh, Ha, Ha, Gg, Gg, Gg, Aa, Aa^Fp, Aa^Fms, Aa^Vhr, Aa^Esa, Aa, Gg, Gg, Gg, Gg, Gg, Gg, Gg, Gg, Rb, Aa, Aa, Gg, Gg, Gg, Ha, Gg, Hh, Hh, Ha^Fp, Mm, Mm, Mm, Mm, Mm, Mm, Mm, Ms^Xm, Ms^Xm, Ms^Xm
Ha, Gg, Gg, Hh, Hh, Ms, Ms, Hh, Hh, Gg, Gg, Gg, Gg, Gg, Gg, Ha^Fp, Ha, Hh, Aa, Ha^Esa, Gg, Gg, Gg, Gg, Aa, Aa^Fp, Aa, Aa, Aa, Aa, Rb, Gg^Es, Rb, Gg, Gg, Gg, Gg, Gg, Gg, Gg, Gg, Gg, Gg^Efm, Gg, Gg, Hh, Hh, Hh, Hh, Ms, Ms, Mm, Ms, Mm, Ms, Mm, Ms, Ms^Xm
Hh, Hh, Gg, Hh, Hh, Mm, Hh, Hh, Gg, Gg, Gg, Gg, Gg, Cer, Gg, Gg, Gg, Aa, Gg, Gg, Gg, Gg, Gg, Gg, Gg, Gg, Gg, Gg, Gg, Gg^Es, Gg, Rb, Gg, Rb, Rb, Rb, Rb, Gg, Gg, Gg, Gg, Gg, Gg, Gg, Gg, Gg, Gg, Hh, Gg, Hh, Ha, Ms, Chr, Mm, Mm, Mm, Mm, Ms
Hh^Fms, Hh, Gg, Gg, Gg, Hh, Hh, Hh, Gg, Gg, Aa^Vhr, Aa, Aa, Gg, Gg, Aa, Gg, Gg, Gg, Gg, Gg, Gg, Gg, Gg, Gg, Gg, Gg, Gg, Rb, Gg, Gg, Gg, Gg, Gg, Gg, Gg^Es, Gg, Rb, Gg, Gg, Gg, Gg, Aa, Gg, Gg, Gg, Gg, Gg, Gg, Hh, Hh, Ha, Ha, Ms^Xm, Ms, Mm, Ms, Ms
Aa^Fp, Aa^Fp, Gg^Fms, Gg, Gg, Gg, Gg, Gg, Gg, Gg, Gg, Gg, Gg, Gg, Gg, Gg, Gg, Gg, Aa, Gg, Aa, Ha, Ha^Fp, Aa, Aa^Esa, Aa, Aa, Rb, Rb, Re, Re, Gg, Gg^Fms, Gg, Gg, Gg, Gg, Aa, Aa^Esa, Gg, Aa, Aa, Aa^Fp, Aa, Aa, Gg, Gg, Gg, Gg, Gg, Ha, Ha^Esa, Hh, Ha^Fp, Ms, Ms, Ms, Mm
Aa^Fp, Aa^Fp, Aa^Fma, Gg, Gg, Gg, Gg, Gg, Gg, Gg, Gg, Gg, Gg, Gg, Gg, Gg, Gg, Gg, Aa, Aa^Esa, Ha, Ha, Aa, Aa, Gg, Aa, Rb, Rb, Rb, Re, Gg, Gg, Gg^Fms, Aa^Fp, Aa, Gg, Gg, Rb, Aa, Aa^Vwm, Aa, Aa^Fp, Aa, Aa, Aa, Aa^Esa, Gg, Gg, Gg, Gg, Gg, Ha, Ha, Hh, Hh^Vu, Ms, Ms, Mm
Ha, Ha^Esa, Hh, Gg, Gg^Efm, Gg, Gg, Gg, Gg, Gg, Gg, Gg, Gg, Gg, Gg, Gg, Gg, Gg, Aa, Ha^Fp, Ha^Esa, Ha^Esa, Hh, Gg, Gg, Aa, Rb, Rb, Gg, Gg, Gg, Gg, Gg, Aa, Aa^Esa, Aa, Rb, Rb, Aa^Fp, Re, Gg, Aa, Aa, Aa^Vha, Aa, Aa, Aa^Fms, Gg, Gg, Gg, Gg, Gg, Ha, Hh, Mm, Mm, Ms, Ms
Ms, Ms, Ms, Ha, Ms, Hh, Ha, Hh, Gg^Efm, Gg, Gg, Gg, Gs^Fms, Gg^Efm, Gs^Fms, Gg, Gg, Gg, Aa, Ha, Ha, Hh, Gg, Gg, Gg, Gg, Gg, Gg, Gg, Gg, Rb, Rb^Es, Rb^Es, Gg, Aa, Aa^Fp, Gg, Rb, Re, Re, Gg, Aa, Aa, Aa, Gg^Esa, Aa, Aa^Fp, Gg, Gg, Gg, Gg, Gg, Hh, Mm, Ms, Mm, Ha^Fp, Mm
Ms, Ms, Ms, Ms, Ms, Ms, Ms, Ha^Esa, Hh^Fms, Gs^Fms, Aa^Fms, Gll^Fp, Aa^Fms, Gll^Fp, Aa^Fp, Gll^Fp, Gs^Fms, Gg, Gg, Gg, Gg, Gg, Gg, Gg, Aa, Aa, Rb, Gg, Rb, Rb, Gg, Gg, Gg, Rb, Aa, Aa, Gg, Rb, Gg, Gg, Rb, Rb, Re, Re, Aa, Aa, Gg, Gg, Gg, Gg, Gg, Gg, Gg, Hh, Ha, Ha^Esa, Ha, Ha
Ms, Ms, Ms, Ms, Ms, Ms, Ms, Ha, Hh^Fp, Ha^Fms, Aa^Fma, Gll^Fp, Gll^Fp, Aa^Fp, Gs^Fms, Gs^Fms, Aa^Fms, Aa^Fp, Aa^Fms, Gg, Gg, Gg, Rb, Gg, Aa, Rb, Gg, Rb, Ce, Gg, Gg, Gg, Gg, Aa^Fp, Gg, Aa^Esa, Aa, Aa^Vha, Gg, Re, Aa^Fp, Rb, Re, Re, Re, Re, Re, Gg, Ce, Gg, Gg, Gg, Gg, Gg, Hh, Ha, Re, Ha
Ms, Ms, Hh^Fms, Ms, Ha^Fms, Ms, Ha^Fms, Ha^Fp, Hh^Fp, Hh^Fms, Aa^Fp, Aa^Fma, Aa^Fms, Gll^Fp, Gs^Fms, Aa^Fp, Aa^Fms, Aa^Fp, Gs^Fms, Gll^Fp, Gg, Rb, Gg, Aa, Aa^Esa, Aa, Gg, Gg, Ke, Ce, Gg, Gg, Gg, Gg, Gg, Gg, Gg, Gg, Gg, Aa, Aa, Aa, Aa, Aa, Gs, Gs, Ce, Ce, Gg, Gg^Efm, Gg, Gg, Gg, Gg, Gg, Gg, Gg, Hh
Ha^Fms, Ha^Fp, Ha^Fms, Hh^Fp, Hh^Fms, Hh^Fp, Hh^Fms, Hh^Fp, Hh^Fms, Hh^Fms, Aa^Fp, Gll^Fma, Gg, Gs^Fms, Gll^Fp, Aa^Fp, Gs^Fms, Gll^Fp, Gs^Fms, Gs^Fms, Gg, Rb, Gg, Aa^Fp, Aa, Aa^Vha, Gg, Ce, Gg, Gg, Gg, Gg, Gg, Gg, Gs^Fms, Gs^Fms, Gg, Gg, Gg, Gg, Re, Re, Gg, Gg, Gg, Gs, Ce, Ke, Aa, Gg, Gg, Gg, Gg, Gg^Efm, Gg, Gg, Gg, Gg
Hh^Fms, Ha^Fp, Hh^Fp, Hh^Fms, Hh^Fp, Hh^Fp, Hh^Fms, Ha^Fp, Hh^Fp, Gll^Fp, Gll^Fp, Gll^Fp, Gg, Gg, Gg^Efm, Gll^Fp, Gs^Fms, Gs^Fms, Gll^Fp, Gg, Gg, Rb, Gg, Gg, Gg, Gg, Gg, Gg, Gg, Gg, Gll^Fp, Gs^Fms, Gll^Fp, Gs^Fms, Gll^Fp, Gll^Fp, Gll^Fp, Gg, Gs^Fms, Gg, Gg, Re, Gg, Gg, Gg, Gg, Gg, Gg, Gs^Fms, Gg, Gg, Gg, Gg, Gg, Gg, Gg, Gs^Fms, Gg
Hh^Fp, Hh^Fp, Ha^Fp, Ha^Fp, Ha^Fms, Ha^Fma, Aa^Fma, Gll^Fp, Gll^Fp, Gg, Gg, Gg, Rb, Gg, Gg, Gg, Gg, Gg, Gg, Gg, Rb, Rb, Gg, Gg, Aa^Fp, Gg, Gs^Fms, Gg, Gs^Fms, Gll^Fp, Aa, Gll^Fp, Aa, Gg, Gll^Fp, Aa, Aa, Gll^Fp, Gs^Fms, Gg, Aa, Gg, Gg, Gg, Gg, Gg, Gs^Fms, Gs^Fms, Aa^Fms, Gg, Gll^Fp, Gs^Fms, Aa^Fp, Gs^Fms, Aa^Fp, Gs^Fms, Gs^Fms, Gs^Fms
Ha^Fp, Hh^Fms, Hh^Fp, Ha^Fms, Gg^Fp, Gs^Fms, Gg^Efm, Gg, Rb, Gg, Rb, Rb, Gg, Aa, Aa, Gg, Rb, Gg, Gg, Gg, Rb, Gg, Gg, Gs^Fms, Gll^Fp, Aa^Fp, Gll^Fp, Aa^Fms, Aa^Fp, Aa^Fp, Aa^Fms, Aa^Fp, Aa, Aa^Fp, Gll^Fp, Gg, Aa^Fp, Aa^Fp, Aa^Fp, Gg, Aa, Ce, Ke, Ce, Gs, Gg, Gs^Fms, Gs^Fms, Gll^Fp, Gs^Fms, Gll^Fp, Aa^Fp, Gll^Fp, Aa^Fms, Aa^Fp, Gs^Fms, Gs^Fma, Gll^Fp
Ha^Fp, Hh^Fp, Gg, Gg^Es, Gg, Gg, Rb, Rb, Gs^Fms, Rb, Gs^Fms, Gg, Aa^Fms, Aa^Fp, Gs^Fms, Rb, Aa, Rb, Aa^Esa, Rb, Gg, Gg, Gll^Fp, Gs^Fms, Gg, Gg, Gs^Fms, Aa^Fp, Aa^Fp, Gs^Fms, Gll^Fp, Gg, Gll^Fp, Aa, Gll^Fp, Gll^Fp, Gg^Fp, Gll^Fp, Gll^Fp, Gs^Fms, Gll^Fp, Gg, Ce, Ce, Gg, Gg, Gll^Fp, Aa^Fms, Aa^Fp, Aa, Gg, Gs^Fms, Gll^Fp, Aa^Fp, Aa^Fp, Aa^Fp, Aa^Fma, Gs^Fms
Gg, Gg, Aa, Gg, Rb, Rb, Gg, Aa^Fms, Aa^Fms, Gs^Fms, Aa^Fp, Aa^Fp, Aa^Fma, Aa^Fp, Gll^Fp, Aa^Fms, Aa, Aa, Aa, Gg, Gg^Efm, Gll^Fms, Aa^Fp, Gs^Fms, Aa^Esa, Gs^Fms, Gs^Fms, Gs^Fms, Aa, Gg, Gs^Fms, Aa, Aa, Aa^Fp, Aa^Fp, Gll^Fp, Gll^Fp, Gll^Fp, Gs^Fms, Gg, Aa^Fp, Gg, Gg, Gg^Efm, Gg, Gg^Fp, Aa^Fma, Aa^Fms, Aa^Fp, Aa^Vea, Aa^Fp, Aa^Fp, Gs^Fms, Gg, Aa, Aa^Fp, Gll^Fp, Gll^Fp
Rb, Rb, Aa^Fp, Aa, Aa^Fp, Gs^Fms, Gs^Fms, Aa^Fp, Aa, Gs^Fms, Gg, Gs^Fms, Gs^Fms, Aa^Fma, Aa, Gs^Fms, Aa^Fms, Aa^Vea, Aa^Fma, Aa, Aa^Fma, Aa^Fma, Gll^Fms, Gll^Fp, Aa^Fp, Gs^Fms, Aa, Gll^Fp, Aa, Aa, Gs^Fms, Gll^Fp, Aa^Esa, Aa^Fp, Gs^Fms, Gll^Fp, Aa^Fma, Gll^Fp, Aa^Fp, Gs^Fms, Gg^Fp, Aa, Gg, Gg, Gg, Gg, Gg, Gll^Fp, Gll^Fp, Aa^Fp, Gll^Fp, Gs^Fms, Gll^Fp, Gg, Gll^Fp, Gll^Fp, Gg^Fp, Gll^Fp
Aa, Aa, Aa, Aa^Fp, Aa, Aa^Fms, Gs^Fms, Gg, Aa^Fms, Aa^Fp, Gll^Fp, Aa^Fp, Gll^Fp, Gg, Aa^Fma, Gll^Fp, Gs^Fms, Aa^Fp, Aa^Fma, Aa^Fma, Gll^Fp, Aa^Fma, Gs^Fms, Gll^Fp, Aa^Fp, Aa^Fp, Aa^Fp, Gll^Fp, Gs^Fms, Gs^Fms, Gs^Fms, Aa^Fp, Gs^Fms, Gs^Fms, Aa^Fp, Gs^Fms, Gg, Aa^Fma, Gs^Fms, Gll^Fp, Gs^Fms, Aa, Gg, Gg, Gg, Gg, Gs^Fms, Gs^Fms, Aa^Fp, Gs^Fms, Aa^Fp, Gs^Fms, Aa^Fp, Gll^Fp, Gll^Fp, Aa^Fms, Aa^Fms, Gll^Fp
Aa^Fms, Gll^Fma, Aa^Fp, Aa, Gll^Fp, Gg^Efm, Aa, Gs^Fms, Gll^Fp, Gll^Fp, Gs^Fma, Gll^Fp, Gll^Fp, Aa^Fma, Gs^Fms, Aa^Fma, Gll^Fp, Gll^Fma, Gll^Fp, Aa^Fma, Gs^Fp, Gll^Fp, Gll^Fp, Aa^Fms, Aa, Aa^Fms, Aa^Fp, Gs^Fms, Gs^Fms, Gs^Fms, Aa^Fp, Aa^Fp, Aa^Fp, Gll^Fp, Aa, Aa, Gg, Gs^Fms, Gs^Fms, Gs^Fms, Aa, Gg, Gg, Gg, Gg, Aa^Fms, Aa^Fms, Aa, Gg, Aa, Gll^Fp, Gs^Fms, Aa^Fp, Aa^Fp, Aa^Fp, Aa^Fms, Aa^Fp, Gll^Fp
Aa^Fma, Aa^Fma, Aa^Fma, Aa^Fma, Aa^Fp, Aa^Fp, Gs^Fms, Gll^Fp, Aa^Fp, Gs^Fms, Aa, Aa^Fp, Gs^Fms, Gll^Fp, Aa, Gll^Fp, Aa^Fp, Gll^Fp, Gs^Fms, Gg^Es, Gs^Fms, Gs^Fp, Gs^Fms, Aa^Fms, Gs^Fp, Gs^Fms, Gg^Fms, Aa, Gg^Fp, Aa^Fp, Gs^Fms, Gs^Fms, Gll^Fp, Gs^Fms, Aa^Fp, Gg^Fms, Gg, Aa^Esa, Gs^Fms, Gs^Fms, Aa, Gg, Gll^Fp, Gg, Gg, Gg, Gs^Fms, Gg, Gs^Fms, Gll^Fp, Gs^Fms, Aa^Fms, Aa^Fp, Aa^Fp, Aa^Fp, Aa^Fp, Gll^Fp, Aa^Fms
Aa^Fp, Gs^Fms, Aa^Fms, Gll^Fp, Aa^Fms, Gs^Fms, Gll^Fp, Gll^Fp, Gll^Fp, Gs^Fms, Aa, Gll^Fp, Aa^Fp, Aa, Aa^Fms, Gll^Fp, Aa^Fms, Gll^Fp, Aa^Fp, Gg, Gg, Gs^Fms, Gs^Fms, Aa^Fp, Gg, Gs^Fms, Gs^Fms, Gg^Fp, Gg, Gg^Fp, Gg^Fp, Gll^Fp, Gg, Gll^Fp, Gg, Gg, Aa, Aa, Gs^Fms, Gg^Fms, Gll^Fp, Gs^Fms, Gg, Gg, Gg, Gg, Gs^Fms, Gll^Fp, Gll^Fp, Gs^Fms, Gll^Fp, Aa, Gll^Fp, Aa^Fp, Gll^Fp, Aa^Fp, Gll^Fp, Aa^Fp
