Mm, Mm, Mm, Mm, Mm, Mm, Ms, Gs, Mm, Gg, Ms^Xm, Gs, Mm, Rb, Ms^Xm, Ms^Xm, Ms^Xm, Ss, Hh, Wwg, Ha, Wwg, Wwg, Hh, Mm, Ms, Mm, Mm, Mm, Hh, Hh, Gg, Gg, Gg, Gg, Rb, Rb, Rb, Rrc, Rrc, Rp, Aa, Aa, Rb, Gg, Gg, Gg, Gg, Hh, Mm, Ms, Mm, Mm, Ms, Ms, Mm, Ms, Ms^Xm, Ms, Ms^Xm, Ms^Xm, Ms, Ms, Ms^Xm, Ms^Xm, Ms^Xm, Ms, Ms^Xm, Ms^Xm, Ms^Xm
Mm, Mm, Ms, Ms, Ms^Xm, Ms^Xm, Mm, Mm, Mm, Ms^Xm, Ms^Xm, Mm, Mm, Mm, Mm, Ms^Xm, Mm, Mm, Ms, Ha, Ha, Hh, Wwg, Hh, Ha, Ha, Mm, Mm, Mm, Hh, Hh, Aa^Esa, Aa, Gg, Gg, Rb, Gg, Gg, Gg, Aa, Gg, Rp, Rrc, Rrc, Gg, Gg, Gg, Gg, Hh, Ha, Ha^Esa, Mm, Mm, Mm, Ms, Ms, Ms, Ms, Ms, Ms, Ms, Ha^Esa, Ha^Esa, Ms^Xm, Ms, Ms, Ms, Ms, Ms^Xm, Ms^Xm
Ms, Ms, Ms, Ms, Ms^Xm, Ms^Xm, Mm, Mm, Mm, Ms, Ms, Ms, Mm, Mm, Wwf, Aa^Esa, Wwf, Ha, Ha, Ms, Ha^Esa, Hh, Wwg, Sm, Sm, Ha^Esa, Hh, Mm, Ms, Ms, Ha, Hh, Ha, Gg, Hh, Rb, Rb, Aa, Aa, Gg, Gg, Ce, Ce, Ce, Ce, Gg, Gg, Gg, Gg, Ha, Ha, Mm, Mm, Mm, Ms, Ms, Ms, Ms, Ms, Ms, Ms, Ha, Ha, Ha, Ms^Xm, Ms, Ms, Ms^Xm, Ms^Xm, Ms^Xm
Ms, Ms, Ms, Ms^Xm, Ms, Mm, Ms, Mm, Mm, Ms, Mm, Mm, Mm, Wwf, Mm, Wwf, Mm, Wwg, Wwg, Ha, Wwg, Ha, Ha, Wwg, Wwg, Ha, Hh, Ms, Ms, Ms, Ms, Mm, Mm, Ha, Hh, Rb, Rb, Aa^Esa, Gg, Aa, Gg, Ce, Ce, Ce, Ce, Aa^Esa, Gg, Gg, Gg, Gg, Gg, Hh, Mm, Ms, Ms, Ms, Ms, Ms, Ms, Ms, Ms, Ms, Ms, Ms^Xm, Ms^Xm, Ms, Ms, Ms, Ms, Ms^Xm
Ms, Ms, Ms, Ms, Ms, Ms, Ha^Fpa, Ha, Ha, Mm, Rr, Mm, Ce, Mm, Ce, Mm, Rrc, Co, Co, Wwg, Mm, Wwg, Wwg, Wwg, Co, Wwg, Hh^Fp, Ha^Fp, Mm, Mm, Ms, Ha, Ha^Esa, Hh, Hh, Hh, Hh, Gg, Gg, Gg, Gg, Rb, Rb, Ket, Ce, Aa, Gg, Aa, Aa, Aa^Fpa, Hh, Ha^Esa, Chr, Mm, Mm^Xm, Ms, Ms^Xm, Ms, Ms, Ms, Ha^Esa, Ms, Ms, Ms, Ms, Ms^Xm, Ms^Xm, Ms, Ms^Xm, Ms^Xm
Mm, Mm, Ms, Ms, Ms, Ms, Ha^Fpa, Ha, Rp, Ce, Ss, Rp, Rrc, Rrc, Rp^Em, Rrc, Rrc, Rrc^Vo, Rrc, Gg^Es, Rp, Coa, Co, Aa, Rb, Wwg, Wwg, Hh^Fp, Ha, Coa, Ms, Ha^Voa, Ha, Ha, Hh, Hh, Gg, Rb, Rb, Aa^Fma, Aa^Fpa, Rb, Aa, Gg, Gg, Rrc, Rrc, Gg, Gg, Aa^Fpa, Gg, Hh, Hh, Hh^Fpa, Hh, Ha^Vu, Ms, Ms, Ms, Ha, Ha, Ha^Esa, Ha^Fpa, Ms, Ms, Ms^Xm, Ms^Xm, Ms^Xm, Ms, Ms
Ms^Xm, Mm, Ms, Ms, Ms, Ms, Aa, Aa, Rr, Rb, Ss, Ss, Wwf, Aa^Esa, Aa, Rb, Rb, Rrc, Rp, Rrc, Rrc, Rrc, Rrc, Rb, Rb, Co, Coa, Wwg, Hh, Ha, Ms, Ms, Ms, Ha, Hh, Gg, Gg, Rb, Rb, Gg, Gg, Gg, Aa^Fpa, Aa^Fpa, Gg, Aa, Aa^Esa, Aa, Aa, Gg, Gg, Gg, Gg, Gg, Gg, Hh, Hh, Ms, Ha^Esa, Ha, Ms, Hh^Fpa, Ms, Hh, Ms, Ms, Ms, Ms, Ms, Ms
Ms^Xm, Ms^Xm, Ms, Ms, Mm, Mm, Mm, Cea, Rb, Ss, Sm, Sm, Sm, Wwf, Wwf, Rb, Coa, Co, Rp, Rb, Rrc, Rp, Aa, Rb, Rb, Co^Vo, Re, Wwg, Wwg, Hh, Hh^Fp, Ms, Mm, Ha, Hh, Hh, Gg, Aa, Gg, Gg, Gg, Gg, Aa, Aa^Fpa, Gg, Gg, Rp, Aa, Aa, Gg, Gg, Gg, Gg, Gg, Aa, Gg, Rb, Hh, Hh, Hh^Fpa, Ms, Ha, Hh^Esa, Ms^Xm, Ha^Fpa, Ms, Ms, Ha, Ms^Xm, Ms^Xm
Mm, Ms, Ms, Ms, Mm, Mm, Wwf, Ce, Rb^Es, Ss, Ss, Sm, Ss, Ss, Wwf, Wwf, Wwf, Co, Co, Ko, Rp, Rp, Rb, Aa, Rrc, Rb, Gg, Co, Wwg, Wwg, Hh, Mm, Ms, Ha^Vo, Ha, Hh, Hh, Aa^Fma, Aa, Aa, Gg, Gg, Gg, Gg, Aa, Rp, Gg, Gg, Ce, Gg, Aa, Aa, Gg, Gg, Aa, Aa, Rb, Aa, Hh, Ms^Xm, Ms, Ha, Hh, Ms^Xm, Ha, Ms, Hh^Vud, Ms, Ms^Xm, Ms^Xm
Mm, Mm, Mm, Mm, Aa, Rb, Wwf, Rp, Wwf, Wwf, Sm, Sm, Ss^Vo, Wwf, Gg, Co^Vo, Co, Co, Ko, Coa, Co, Co^Vo, Rb, Gs, Rrc, Rrc, Gs, Wwg, Coa, Wwf, Wwf, Hh, Ms, Ms, Ms, Hh^Voa, Hh, Aa, Aa^Fpa, Aa^Fpa, Rb, Gg, Rb^Vo, Aa, Aa, Gg, Gg, Ce, Ce, Ket, Aa, Aa^Fpa, Gg, Gg, Aa, Aa, Rb, Aa, Hh, Hh, Hh, Hh, Chr, Ms, Ms, Hh, Ms, Ha, Ms, Ms
Ms^Xm, Mm, Mm, Ms, Ms, Aa^Esa, Wwf, Ce, Wwg, Wwg, Wwg, Sm, Wwf, Wwf, Rp^Em, Coa, Rp, Co, Co^Vo, Co, Rp, Co, Rp^Es, Rb, Gg, Rrc, Gs^Es, Re, Aa, Co, Sm, Hh, Coa, Mm, Ms, Ms, Hh, Gg, Aa^Fp, Aa^Fms, Rb, Gg, Gg, Aa, Aa, Gg, Gg, Rb, Ce, Ce, Ce, Gg, Gg, Gg, Gg, Gg, Rb, Hh, Mm, Hh, Hh, Ha^Fp, Mm^Xm, Ms, Ms, Ms, Ms, Ms, Ms^Xm, Ms
Ms^Xm, Ms^Xm, Mm, Ms, Ms, Ms, Ms, Wwf, Wwg, Wwg, Co, Wwg, Aa, Rp, Rb, Rrc, Rp, Ko, Gs^Es, Co, Coa, Rp, Rrc, Aa, Aa, Aa, Rrc, Gg, Aa, Co, Wwg, Hh, Hh, Mm, Hh, Hh, Hh, Gg, Gg, Rb, Rb, Rb, Gg, Gg, Rrc, Gg, Gg, Gg, Aa, Ce, Gg, Gg, Gg, Gg, Gg, Gg, Hh, Hh^Fp, Ms^Xm, Ms, Ha, Ms, Ms, Ms, Mm^Xm, Ms, Ms, Ms^Xm, Ms, Ms
Mm, Mm, Ms, Ms, Ms, Ms, Mm, Mm, Mm, Wwg, Wwg, Co, Aa, Rb, Rb, Rb, Aa, Rp, Rd, Coa, Rb, Rb, Gg^Vo, Rrc, Rrc, Re, Rb, Rrc, Rrc^Vo, Rrc, Rrc, Wwf, Rb^Em, Hh, Rrc, Hh, Rp, Gg^Es, Rrc, Re, Re, Re, Gg, Rrc, Gg, Gg, Gg, Aa, Aa, Aa, Aa, Gg, Gg, Gg, Rb, Hh, Ha, Ms, Ms^Xm, Ms, Ha^Esa, Ms, Ha^Esa, Hh^Fp, Ms^Xm, Ms, Ms, Ms, Ms, Ms
Mm, Mm, Mm, Ms, Mm, Ms, Ms, Ms, Ms, Sm, Wwg, Rb, Gs, Rb, Gs, Aa, Aa, Rrc, Rrc, Aa, Rrc, Rrc, Rrc, Rrc, Gg^Es, Gg^Es, Rb, Rrc, Ce, Rp, Rp, Rrc, Rp, Rrc, Ha, Rp, Ha, Rrc, Gg, Rrc, Rp, Gg, Rp, Aa, Rb, Gg, Gg, Aa, Aa, Aa, Gg, Gg, Rb, Rb, Hh, Ha, Ms, Mm, Mm, Mm, Hh, Mm, Ha, Ms, Ms, Ms, Ms^Xm, Ms, Ms, Ms^Xm
Ms, Ms, Ms, Mm, Mm, Ms, Ms, Ms, Ms, Mm, Wwg, Co, Wwf, Wwf, Gg^Vo, Rrc, Rb, Rb, Rrc, Rrc, Rp, Rb, Aa, Rb, Aa, Rb, Rb, Rb, Wwg, Wwg, Wwg, Wwf, Co, Hh, Mm, Ha, Hh, Gg, Aa, Aa, Gg, Rp, Gg, Gg, Aa, Aa, Gg, Aa, Aa, Gg, Gg, Rb, Aa, Aa, Hh, Ha^Fp, Mm^Xm, Ms^Xm, Hh, Mm, Hh, Ha, Ha, Ms, Ms, Ms, Ms, Ms, Ms, Ms
Ms, Ms, Ms, Ms, Ms, Ms, Ms, Ms, Mm, Mm, Sm, Wwg, Wwg, Wwrg, Aa, Aa^Es, Rb, Rb, Rp, Rb, Gs, Aa, Aa, Rp, Aa^Vo, Aa, Rd, Gs, Coa, Ss, Hh, Hh, Ms, Mm, Hh, Hh^Voa, Hh, Gg^Es, Aa, Aa, Gg, Gg, Aa^Fp, Gg, Gg^Es, Rb, Gg, Ce, Ce, Gg, Gg, Rb, Aa, Hh, Ha, Mm, Mm, Chr, Hh, Hh, Ms, Ha^Fp, Mm, Ms, Mm^Xm, Ms, Mm^Xm, Ms, Mm^Xm, Ms
Ms, Ms, Ha, Ha, Ha, Ms, Sm, Ss, Ss, Rb, Wwg, Wwg, Ss, Co, Wwf, Aa^Esa, Wwf, Rb, Rp, Rp, Aa, Gg, Rb, Rrc, Rd, Re, Wwg, Co, Wwg, Hh, Hh, Hh^Fp, Ms, Ms, Hh, Hh, Hh, Gg, Gg, Gg, Gg, Aa, Aa, Gg, Gg, Rb, Ce, Ce, Gg, Gg, Gg, Rb, Hh, Hh, Hh, Hh, Ha^Esa, Ha, Hh, Ms, Ms, Mm, Mm^Xm, Mm^Xm, Xu, Ms^Xm, Xu, Ms^Xm, Ms^Xm, Ms^Xm
Hh, Ha^Esa, Ai, Ai, Ai, Wwg, Ha, Ss, Hh, Wwg, Sm, Ss, Ss, Wwg, Wwg, Wwg, Co, Co, Co, Re, Wwg, Re, Co, Rp, Co, Wwg, Wwg, Wwg, Hh, Hh, Ms, Ms, Ha, Hh, Ha, Hh, Gg, Gg, Aa^Voa, Gg, Gg, Gg, Gg, Gg, Aa, Aa, Ce, Ket, Ce, Rb, Aa^Fpa, Aa, Hh, Hh, Hh, Hh, Ha, Ha, Ms, Ms, Mm, Mm, Mm, Xu, Uh, Xu, Uh, Mm^Xm, Xu, Ms^Xm
Mm, Ha, Mm, Hh, Ms, Ha, Ha, Hh, Hh, Hh, Sm, Sm, Ss, Sm, Sm, Wwg, Wwg, Wwg, Wwg, Ss, Sm, Co, Wwg, Rb, Wwg, Wwg, Sm, Hh, Hh^Fpa, Mm, Ms, Ms, Ha, Ha, Gg, Gg, Gg, Aa, Aa^Fpa, Aa, Gg, Gg, Gg, Aa, Aa, Aa, Rb, Ce, Gg, Rb, Aa^Fpa, Hh^Fpa, Ha^Fp, Ha^Vhha, Ms^Xm, Hh, Hh, Ha, Ms, Mm, Ms^Xm, Ms^Xm, Xu, Uh^Vu, Cte, Cte, Cte, Uh, Xu, Xu
Ms, Ms, Ms, Ha^Esa, Ms, Ms, Mm, Ha, Mm, Hh, Ha, Sm, Ha^Esa, Ss, Hh, Ss, Hh, Hh, Hh, Hh, Hh, Wwg, Hh, Ss, Ha, Ha, Coa^Vo, Mm, Mm, Mm, Ha, Ha, Ha, Hh^Efm, Gg, Gg, Gg, Gg^Fp, Gg^Fpa, Gg, Gg, Gg, Gg, Aa, Gg, Gg, Gg, Rb, Gg, Gg^Fms, Gg^Fp, Hh, Ha, Mm, Mm, Mm, Ha^Fpa, Ha^Esa, Mm, Mm, Ms^Xm, Xu, Xu, Uh, Uh, Kte, Uu, Uu^Vu, Xu, Xu
Ha, Ms, Ha, Ha, Ha, Mm, Ms, Ms, Ms, Ms, Ha, Hh, Hh, Aa^Fpa, Hh^Voa, Hh^Fp, Mm, Mm, Mm, Hh, Ha, Hh, Coa, Hh, Aa^Fms, Ms, Ha, Mm, Hh, Hh, Hh, Hh, Gg, Gg, Rb, Rb, Gg, Gg, Gg, Gg, Gg, Gg, Aa, Gg, Gg, Gg, Aa, Aa, Gg, Gg, Gg^Fms, Hh, Ha, Mm, Ms, Ms, Mm, Ha, Chr, Mm, Ha^Esa, Ha, Uh, Uh, Uh, Cte, Uu, Uu, Uh, Xu
Hh, Hh, Hh, Hh, Mm, Ms, Mm, Ms, Mm, Mm, Ms, Mm, Ms, Ms, Ms, Ha^Fpa, Mm, Ms, Hh, Mm, Mm, Mm, Ha, Mm, Ms, Ms, Ha, Hh, Rb, Hh, Gg, Gg, Gg, Gg, Rb, Rb, Re, Gg, Rb, Gg, Gg, Gg, Aa, Aa^Vhr, Gg, Gg, Aa, Aa, Aa, Gg, Gg, Gg, Hh, Hh, Ms, Ms, Mm^Xm, Ha, Ha, Hh, Ha, Ha, Chr, Hh, Hh, Hh, Hh, Uu, Uh, Xu
Mm, Ms, Ha^Esa, Hh, Hh, Mm, Aa, Mm, Ms, Ms, Ms, Ms, Hh, Ms, Ha, Mm, Hh, Hh, Hh, Hh^Vo, Ha, Mm, Ha, Hh, Hh, Ha, Hh, Hh, Rb, Rb, Gg, Gg, Gg, Ha^Fp, Hh, Hh, Re, Gg, Rb, Rb, Rb, Gg, Gg, Gg, Gg, Gg^Es, Rb, Aa, Gg, Gg, Gg, Gg, Hh, Hh, Hh, Mm, Ms, Ha^Esa, Ha, Ha, Mm, Mm^Xm, Xu, Hh^Vu, Hh, Uh, Uh, Uh, Xu, Xu
Mm, Ms, Mm, Hh, Ms, Aa, Aa, Aa^Esa, Aa, Hh, Mm, Mm, Ms, Hh, Ha, Ha^Esa, Aa, Ha, Ha, Hh, Ha, Ha, Rb, Hh, Hh, Ha, Aa^Esa, Rb, Gg, Gg, Gg, Gg, Gg, Hh, Ha, Hh, Gg, Gg, Gg, Gg, Gg, Gg, Rp, Rp, Gg^Es, Gg, Gg^Esa, Gg, Gg, Gg, Aa^Fpa, Gg, Hh, Hh, Hh, Chr, Ms, Ha, Hh, Ha^Fpa, Mm, Ms^Xm, Ms^Xm, Xu, Ms, Xu, Xu, Xu, Xu, Xu
Ms, Ms, Ms, Mm, Mm, Ms, Ms, Ha, Ms, Ha, Ha, Ms, Ms, Ha, Gg, Gg, Gg, Gg, Gg, Rb, Rb, Rb, Rb, Re, Gg, Aa, Cer, Rb, Gg, Gg, Hh, Gg, Gg, Hh, Hh, Hh, Gg, Gg, Aa, Gg, Aa, Rb, Gg, Gg, Gg, Aa, Aa, Aa, Re, Rb, Aa^Esa, Aa, Gg, Hh, Ha^Fpa, Hh, Hh, Hh, Hh, Ha^Vu, Ms, Ms, Ms^Xm, Ms, Ms^Xm, Ms^Xm, Ms^Xm, Xu, Ms^Xm, Ms^Xm
Ms, Ms, Ms, Ms, Ms, Ms, Ms, Ms, Ms, Ms, Hh, Mm, Hh, Hh, Gg, Gg, Hh, Gg, Ha, Gg, Gg, Rb, Gg, Gg, Gg, Aa, Gg, Gg, Ha, Hh, Aa^Fpa, Ha, Ce, Gg, Ce, Ce, Gg, Aa^Es, Aa, Aa^Esa, Aa, Gg, Gg, Gg, Gg, Gg, Gg, Aa, Gg^Fp, Rb, Aa, Aa, Aa^Esa, Gg, Hh, Hh, Hh, Hh, Hh, Ms^Xm, Ms, Ms, Mm, Mm, Mm, Ms^Xm, Ms^Xm, Ms^Xm, Ms^Xm, Ms^Xm
Mm, Ms, Ms, Ms, Ms, Ms, Mm, Mm, Ms, Ms, Ms, Ha, Aa^Esa, Gg, Gg, Gg, Ms, Gg, Hh, Ha, Gg, Gg, Aa^Esa, Gg, Gg, Gg, Gg, Gg, Hh, Hh, Ha, Hh, Ce, Ce, Ket, Ce, Aa^Fp, Aa^Fms, Aa^Vhr, Aa, Aa, Gg, Gg, Gg, Gg, Gg, Gg, Gg, Gg, Rb, Aa, Aa, Gg, Gg, Gg, Ha, Gg, Hh, Hh, Hh^Fp, Mm, Mm, Mm, Mm, Mm, Mm, Mm, Ms^Xm, Ms^Xm, Ms^Xm
Ha, Ms, Ms, Ms, Mm, Mm, Ms, Ms, Ms, Ms, Ha, Aa, Aa, Gg, Gg, Hh, Ha^Esa, Ms, Ms, Hh, Ha, Aa, Aa, Gg, Gg, Gg, Gg, Aa^Fpa, Ha, Hh, Aa, Ha, Rb, Ce, Ce, Ce, Aa, Aa^Fp, Aa, Aa^Esa, Gg, Gg, Rb, Gg^Es, Rb, Aa, Aa, Gg, Gg, Gg, Gg, Gg, Gg, Gg, Aa, Gg, Gg, Hh, Hh, Hh, Hh, Ms, Ms, Mm, Ms, Mm, Ms, Mm, Ms, Ms^Xm
Ha^Fp, Ha, Ha, Mm, Mm, Ms, Ms, Ms, Ms, Ms, Ha, Ha^Esa, Hh, Hh, Gg, Ha, Ha, Ms, Hh, Ha, Aa, Aa, Gg, Gg, Gg, Cer, Gg, Gg, Gg, Aa, Rb, Rb, Rb, Ce, Ce, Gg, Gg, Gg, Gg, Gg, Gg, Gg^Es, Gg, Rb, Aa, Aa, Aa^Esa, Aa, Aa, Gg, Gg, Gg, Gg, Aa, Aa, Aa^Esa, Aa, Gg, Gg, Hh, Gg, Hh, Ha^Esa, Ms, Chr, Mm, Mm, Mm, Mm, Ms
Ha^Fp, Ha, Hh^Fms, Ha, Ha, Ms, Ha^Fp, Ha, Ha, Ha, Ha, Hh, Ha^Fms, Hh, Gg, Gg, Gg, Ha, Hh, Hh, Gg, Aa, Aa^Vhr, Aa^Esa, Gg, Gg, Gg, Gg, Gg, Gg, Gg, Gg, Gg, Gg, Gg, Gg, Gg, Gg, Gg, Gg, Rb, Gg, Gg, Gg, Gg, Aa, Gg, Aa, Gg, Rb, Gg, Gg, Gg, Gg, Gg, Aa, Gg, Aa, Gg, Gg, Gg, Hh, Hh, Ha, Ha, Ms^Xm, Ms, Mm, Ms, Ms
