Gs, Gs, Gs^Fms, Gs^Fds, Gs^Fds, Gs^Fds, Gs^Fds, Rb^Fdw, Re, Gd, Re, Gd, Gd, Gs, Gs, Gs, Gs, Gs, Gs, Gs, Gs, Hh, Hh, Hh, Hh, Hh, Hh^Es, Mm, Mm, Mm, Mm, Mm, Mm, Mm, Mm
Gs, Gs, Gs^Fds, Gs^Fds, Gs^Fds, Gs^Fds, Gs^Fds, Rb^Fdw, Rb^Fdw, Re, Re, Gd, Re^Vct, Re, Re, Re, Re, Gs, Gs, Gs, Gs, Gs, Gs, Hh, Hh^Es, Hh, Hh, Mm, Mm, Mm, Hh, Hh, Mm, Mm, Mm
Gs^Fms, Gs^Fds, Gs^Fds, Gs^Fds, Gs^Fds, Gs^Fds, Rb^Fdw, Re^Fms, Rd, Re, Re, Re, Rd, Re, Ke, Ce, Re^Vct, Gg, Gg, Gg, Gs, Gs, Gs, Gs, Hh, Hh, Hh, Hh, Hh, Mm, Hh, Mm, Mm, Mm, Mm^Xm
Hh^Fms, Gs^Fds, Hh^Fms, Gs^Fds, Gs^Fds, Gs^Fds, Rb^Fdw, Rd, Rd^Vct, Rd^Em, Rd, Rd, Re, Re, Ce, Ce, Rb^Fdw, Rb^Fdw, Rb^Fdw, Gg, Gs, Gs, Gs, Gs, Hh, Hh, Mm, Hh, Mm, Hh, Mm, Mm, Mm^Xm, Mm^Xm, Mm^Xm
Hh^Fms, Hh^Fms, Rb^Fdw, Hh^Fms, Hh^Fds, Hh^Fds, Re, Re^Ecf, Rd, Rd, Rd, Ce, Ce, Rd, Rd, Re, Re, Rb^Fdw, Rb^Fds, Rb^Fdw, Gg, Gg, Gs, Gs, Hh, Hh, Mm, Mm, Mm, Mm, Mm, Mm, Mm^Xm, Mm^Xm, Mm^Xm
Hh^Fms, Hh^Es, Hh, Hh, Hh, Hh^Fds, Re, Re, Rd, Rd, Ce, Ke, Rd^Es, Rd, Re, Re, Re, Rb^Fds, Rb^Fdw, Rd^Fds, Gg, Gg, Gs, Gs, Gs, Hh, Hh, Mm, Hh, Hh, Mm, Mm, Mm^Xm, Mm^Xm, Mm
Hh, Hh, Gd, Hh, Hh, Hh, Rd, Rd, Rd, Rd, Rd, Ce, Re, Rd, Re, Re, Gd, Re^Vct, Gs, Gs^Es, Gg, Gg, Gg^Efm, Gs, Gs, Hh, Hh, Hh, Hh, Mm, Mm, Mm, Mm, Mm, Mm
Hh, Hh, Gs, Gd, Re, Re^Vct, Re, Re^Ecf, Re^Es, Rd, Rd, Rd, Ke, Re, Re^Es, Re^Ecf, Re, Gs, Gg, Gg, Gg, Gg, Gg, Gs, Gs, Hh, Hh, Hh, Mm, Mm, Mm, Mm, Hh, Mm, Mm
Hh, Gs, Gg, Gs, Gd, Re, Re, Re, Re, Rd^Vct, Rd, Ce, Ce, Ce, Gd, Re, Gs, Gs, Gg, Gg, Gg, Gg, Gg, Gs, Gs, Gs, Hh, Hh^Es, Mm, Mm, Mm, Hh, Mm, Mm, Mm
Gg, Gg, Gg, Gg, Gs, Re, Re, Gd, Re, Rd, Re, Re, Re, Re, Re, Gs, Gg, Gg, Gg, Gg, Gs^Fds, Gg^Es, Gs^Fds, Gg, Gs, Gs, Hh, Hh, Hh, Mm, Hh, Hh, Mm, Mm, Mm
Gg, Gg, Rb^Fdw, Rb^Fdw, Gs^Fms, Rb^Fdw, Gg^Em, Gs, Gs, Re, Re, Gs, Gs, Re, Gs, Gs, Gs, Gg, Gg^Efm, Gg, Gg, Gs^Fds, Gg, Gs, Gs, Gs, Gs, Hh, Hh, Hh, Hh, Mm, Mm, Mm, Mm
Gg, Gg, Gs^Fds, Rb^Fdw, Gs^Fms, Rb^Fdw, Gs^Fds, Gg, Gs, Re, Gs, Gg, Gs, Gs, Rb, Rb, Rb, Gs, Gs, Gg, Gg, Gg, Gg, Gs, Gg, Gs, Gs, Gd, Hh, Hh, Hh, Hh, Hh, Mm, Mm
Gg, Gg, Gg^Em, Rb^Fdw, Gs, Gs, Rb^Fdw, Rb^Fdw, Gs, Gs, Gg, Gg, Gs, Rb, Rb^Fdw, Rb^Fdw, Rb, Rb^Fds, Rb^Es, Rb, Gg, Gs^Fds, Gg, Gg, Gs, Gs, Gs, Gd, Gd, Hh, Hh, Hh, Hh, Mm, Mm
Gg, Gg, Rb^Fdw, Gs^Fms, Gs, Gs, Gg, Gs, Gs, Gg, Gg, Gg, Gs, Gs^Fds, Rb^Fdw, Rb^Fdw, Rb^Fds, Rb^Fds, Re^Fds, Rb^Fds, Gs, Gs^Fds, Gs, Gs, Gs, Gs, Gs, Gd, Gs, Gd, Hh, Hh, Hh, Hh, Mm
Gs, Gg, Gg, Rb^Fdw, Gg, Gg, Gg, Gg, Gg, Gg, Gs, Gs, Hh, Rb, Rb^Fdw, Rb^Fds, Gs^Fds, Gs^Fds, Gs^Fms, Rb^Fms, Gd, Gd, Gs, Gs, Rb^Es, Re, Gs, Gs, Gs, Gd, Re, Hh, Hh, Hh, Hh
Hh, Gs, Gg, Gg, Gg, Gg, Gg, Gg, Hh, Hh, Hh, Hh^Em, Hh^Fms, Gs, Rb, Rb^Em, Gs^Fds, Gs^Fds, Gs^Fds, Gs^Fms, Rb^Fdw, Gd, Gs, Rb^Es, Rb^Dr, Re, Gs, Gs, Re, Rd, Gs, Re, Hh^Vh, Hh^Emf, Wwr
Hh, Hh, Gs, Gg, Gg, Gg, Gs, Gs, Hh, Hh, Wwf^Es, Hh, Hh, Rb, Hh^Fms, Gs^Fds, Gs^Fds, Gs^Fds, Rb^Fds, Rb^Fds, Rb^Fds, Rb^Fdw, Gs, Rb, Gs, Rd^Es, Re, Rd, Rd, Gs, Re, Hh, Hh^Emf, Wwr, Hh
Hh^Es, Hh^Es, Hh, Gg, Gs, Gg, Gs, Hh, Hh, Hh^Es, Wwf^Es, Hh, Hh, Gg^Fds, Hh^Fms, Gs^Fms, Gs^Fds, Rb^Fdw, Gs^Vc, Rb^Fdw, Gg, Gs, Rb, Gs, Rd, Re, Wwf, Gs, Rd, Re, Rb^Vwm, Re, Ww^Es, Wwr, Hh^Es
Gs^Fds, Hh^Fms, Hh^Fms, Gs, Gs, Gs, Rb^Fdw, Hh, Hh^Fds, Hh^Fds, Wwf^Es, Rb^Fdw, Hh, Hh^Fds, Gs^Fds, Gs^Fds, Rb^Fdw, Gs, Re, Gs, Gs, Rb, Rb, Rd, Re, Wwf, Hh, Wwf, Re, Re, Ww^Es, Ww^Es, Hh, Hh, Hh
Gs^Fds, Hh^Fms, Hh^Fds, Gs, Gs, Gs, Rb^Fdw, Hh, Hh, Hh^Es, Hh, Wwf^Es, Ww^Es, Hh, Rb^Fdw, Rb^Fdw, Ker, Cer, Gg, Re, Re, Gd, Rb, Re, Gs, Gs, Re, Wwf, Ww, Ww, Rb^Gvs, Hh, Hh, Hh, Hh
Rb^Fdw, Hh^Fds, Gs, Hh^Fds, Gs, Gs, Rb^Fdw, Rb^Fdw, Rb^Fdw, Hh, Hh, Rb^Fdw, Ww^Es, Hh, Gd, Rb^Fdw, Cer, Cer, Gs, Gd, Rb, Rb, Rb, Re, Rb, Gs, Gg^Vhr, Gll, Ww, Gd, Re^Vhr, Hh, Hh, Hh, Mm
Gg^Fms, Rb^Fdw, Rb^Fdw, Gs, Gs, Gs, Rb^Es, Rb^Fdw, Gs, Gs, Gd^Vhr, Hh^Emf, Hh, Ww, Ww, Gd, Gs, Gs, Gd^Vhr, Gd, Rb, Re, Ker, Cer, Ww, Rb, Ww^Bw\r, Ww, Rb, Re, Hh, Hh, Hh, Hh^Edt, Mm
Hh^Fds, Rb^Fdw, Gs, Gs, Gs, Rb^Es, Re^Dr, Rb, Gs, Re, Gs, Hh, Gs, Re, Re, Ww, Ww, Gd, Re, Re, Rb, Cer, Ww, Ww, Ww, Ww, Ww, Ww^Bw\r, Rb, Gg, Hh^Fp, Gll^Fp, Mm, Mm, Mm
Hh, Hh, Rb^Fdw, Gs, Gs, Rb, Rb, Re^Es, Re, Re, Gs, Gg, Gs, Re^Vhr, Gs, Gg, Rb, Ww^Bw/r, Ww, Re, Ww, Cer, Ww, Ww, Ww, Ww, Ww, Rb, Gs^Em, Hh, Hh^Fms, Gll^Fp, Mm, Mm, Mm
Hh, Hh, Hh, Hh, Gs, Rb^Es, Gd, Re, Re, Gd, Rb, Gs, Gd, Re, Re, Re, Rd, Gg, Ww, Re^Es, Ww, Ww, Wot, Wot, Wot, Ww, Ww, Gs^Vhr, Hh, Hh^Fp, Hh^Fp, Hh, Mm, Mm, Mm
Hh, Hh^Fet, Hh, Hh^Fds, Gs, Gs, Gd, Gd, Gd, Rd, Rd, Rb, Rb, Rb, Gs, Gs, Rd, Gd, Ww, Ww, Ww, Wot, Wo, Wo, Wot, Wot, Ww, Re, Hh^Fp, Hh^Fp, Mm, Mm, Mm, Mm, Mm
Rb^Fdw, Hh, Hh, Gs, Gs^Eff, Gs^Eff, Gd, Gd, Re^Eff, Rb^Eff, Ww, Re, Rb, Gd, Re, Re^Vhr, Gg, Rb, Ww^Bw\r, Ww, Ww, Wot, Wot, Wo, Wo, Wot, Ww, Wwr, Hh^Fp, Hh^Fp, Hh, Mm, Mm, Mm, Mm
Rb^Fdw, Hh, Gs, Gs^Eff, Gs^Eff, Gs, Gs, Re, Gd, Gs, Re, Ww, Ww^Bw|r, Ww, Ww, Re, Ww, Ww, Ww, Rb, Gg^Vc, Ww, Ww, Wot, Ww, Ww, Ww, Wwr, Hh^Fp, Hh^Fms, Hh^Fms, Mm, Mm, Mm, Mm
Gg^Es, Rb^Fdw, Gg, Gg, Gg, Gg, Gg, Re^Vhr, Gd, Gd, Gs, Re, Rb, Gd, Rb^Fdw, Ww, Ww, Ww, Ww, Re^Gvs, Rb^Fdw, Rb^Fdw, Rb^Fdw, Ww, Ww, Ww, Ww, Ww, Ww^Es, Hh^Fp, Hh^Fp, Mm, Mm, Mm, Mm
Gg^Es, Gg, Gg, Gg, Gg, Gg, Gg, Gg, Gg, Gg, Re, Re, Gd, Rb^Fdw, Gd, Wwr, Ww, Ww, Ww, Ww, Ww, Ww, Ww, Ww, Ww, Ww, Ww, Ww, Ww, Hh, Mm, Mm, Mm, Mm, Mm
